A B	AB
A C h E	AChE
A N O V A	ANOVA
A s t e r	Aster
ASA的	ASA
AST的	AST
B A F	あるBAF	BAF
B P	BP
B P M	BPM
B S R	BSR
B V	BV
B型	B型
C A G	CAG
C B M	CBM
C C L	CCL
C J	CJ
C O I	COI
C U D A	CUDA
C l u s t a l	Clustal
CBM井	CBM井
CI的	CI
COD去除	COD除去
COD的	COD
COD负荷	COD負荷
COI基因	COI遺伝子
CT扫描	CTスキャン
Ca离子	Caイオン
C型	C型
D G G E	DGGE
D S C	DSC
DA的	DA
DNA交叉杂交	DNAクロスハイブリダイゼーション
DNA的交叉	DNAクロス
DNA芯片	DNAミクロアレイ
DNA阳性异常	DNA陽性だ異常だ
DNA限制性	DNA制限
DNA限制性分析	DNA制限分析
E x	Ex
F I T C	FITC
G P U	GPU
G S S	GSS
GG型	GG
GG型基因	GG遺伝子
GPU工程	GPU工学
GSS来源	GSS由来
H L S	HLS
HBV的	HBV
HCV基因	HCV遺伝子
HCV基因分型	HCV遺伝子タイピング
HCV患者	HCV患者
HRT的	HRT
I U S	IUS
I/O的	I/O
Km值	Km値
L P A	LPA
M A O	MAO
M P A	MPA
M a o	Mao
MAO方式	MAO方式
MAO覆盖	MAO被覆
MBR的溶出	MBR溶出
MBR的溶出液	MBR溶出液
MRI所见	MRI所見
N J	NJ
N T U	NTU
NK细胞	NK
O N U	基づくONU	ONU
OH的	OH
OH的结构	OH構造
ONU功能	ONU機能
PCR扩增限制	PCR制限
PCR碱基	PCR塩基
PCR碱基序列	PCR塩基配列
PCR碱基序列测定	PCR塩基配列決定
PCR限制性片段	PCR制限断片
P波	P波
P波方程	P波方程式
Q E D	QED
R E	RE
R F L P	RFLP
R a n d	Rand
R e c i p e	Recipe
S C E	SCE
S F	SF
S M E	SME
S P E	SPE
S Q L	SQL
S i m u l i n k	Simulink
SAP患者	SAP患者
SEM图像	SEM画像
SI的	SI
SI的指数	SI指数
SS浓度	SS濃度
Shen表示	Shen
T G	TG
T G A	TGA
T T T	TTT
T g	Tg
TTT曲线	TTT曲線
V E S	VES
V T	VT
X U L	XUL
XML的搜索引擎	XML検索エンジン
XML的检索	XML検索
X射线	X線
X射线光	X線光
X射线分	X線分
X射线分光	X線分光
X射线分光分析	X線分光分析
X射线电子	X線光電子
X射线电子分光法	X線光電子分光法
X射线衍射	X線回折
一些	いくらか
一例	一例
一定	ある	一定
一控制	一方コントロール
一方面	一方
一方面控制组	一方コントロールグループ
一样	一様だ
一样媒体	一様だ媒体
一样的	一様だの
一种	一種
一种在SAP	するSAP
一种接口	するIF
一致	よく一致	よく一致する	一致	一致する	良く一致する
一致性	良く一致
一致的	一致する	一貫する
一般	一般	一般に
一贯	一貫
一部分	一部
一部分固有	一部固有だの
一部分固有界限	一部固有だ限界
上	上
上升	より上昇	アップする	上げる	上昇	上昇する	向上	向上する
上升因素	向上因子
上市	上場
上市SME	上場SME
上市中小	上場中小
上市中小企业	上場中小企業
上方	上方
上方控制	上方制御	上方制御さ
上皮	上皮
上皮细胞	上皮細胞
上述	上記
上述化学	上記化学
上述化学试剂	上記化学試薬
上述微细	上記微細だ
上述微细结构	上記微細だ構造
上述微细结构变换	上記微細だ構造変換
上述离子	上記イオン
下	下
下位	下位
下位公司	下位会社
下层	下層
下层大气	下層大気
下方	下方
下方控制	下方制御	下方制御さ
下部	下部
下部结构	下部構造
下降	下がる	下降	下降する	低下
下限	下限
不	ぎ	ない	なく
不动	不動
不动点	不動点
不动点问题	不動点問題
不变	不変だ
不变特征	不変だ特徴
不变特征量	不変だ特徴量
不变特征量提取	不変だ特徴量抽出
不可执行	する実行不可能だ	実行不可能だ
不可执行解	する実行不可能だ解	実行不可能だ解
不可能	不可能だ
不可能解	不可能だ解
不合并	不都合だ
不同功能	異なる機能
不同孵化	異なるインキュベーション
不同尺度	異なるスケール
不同指纹	異なるフィンガー	異なるフィンガープリント
不同效果	異なる効果
不同方法	異なる方法
不同显微	異なる微細だ
不同显微结构	異なる微細だ構造
不同条件	異なる条件
不同浓度	異なる濃度
不同的水	異なる水
不同的水供给	異なる水供給
不同翼偏向	異なる翼偏向
不同翼偏向角	異なる翼偏向角度
不同翼型	異なる翼
不同试剂	異なる試薬
不同速度	異なるスピード
不均衡	不均衡だ
不均衡构成	不均衡だ構成
不对	及ぼすぎ
不正当复制	不正だコピー
不法	不正だ
不稳定	不安定だ
不稳定条件	不安定だ条件
不稳定阶段	不安定だ段階
不等式	不等式
不纯	不純だ
不纯物	不純だ物
不良反应	悪い反応
不足	不足
与GH	GH
与Pd粒子	Pd粒子
与SF的	おけるSF
专业	プロ	専門
专利权	特許権
专利权所有	特許権所有
专利权所有公司	特許権所有会社
丘疹	丘疹
丘疹合并	丘疹合併
丘疹合并轻微	丘疹合併軽微だ
丙型肝炎	C型肝炎
丙型肝炎患者	C型肝炎患者
丙型肝炎病毒	HCV
丙型肝炎病毒蛋白酶	HCVプロテアーゼ
丙型肝炎病毒蛋白酶抑制	HCVプロテアーゼ阻害
丙型肝炎病毒蛋白酶抑制剂	HCVプロテアーゼ阻害薬
东	東
丝	Ser
两侧	両側
个数	個所	個数
中国	中国
中国医科	中国医科
中国医科大学	中国医科大学
中国医科大学附属	中国医科大学付属
中国医科大学附属盛京	中国医科大学付属盛京
中国医科大学附属盛京医院	中国医科大学付属盛京病院
中国母	中国母
中国母集团	中国母集団
中央	中央
中央周波	中央周波
中央部	中央部
中小	中小
中小企业	中小企業
中心	センター	中心	都心
中心周围	都心周辺
中性	中性
中性乳制品	中性乳製品
中抽取	より抽出する
中断	ブレーク	中断
中药	漢方薬
中药症状	漢方薬症状
中药综合症	漢方薬症候	漢方薬症候群
中间	中間
中间部分	中間部分
临床	臨床
临床数据	臨床データ
临界	臨界
临界流量	臨界流量
临界路径	臨界径路
临界路径延迟	臨界径路遅れる
为	およそ
为头高	頭高いさが
为所有	およそすべて
为高	高いさが
主要	もたらす主だ	主として	主だ	主要だ
主要传染病	もたらす主だ感染症	主だ感染症
主要依赖	主だ依存	主だ依存する
主要候选	主要だ候補
主要倾向	主要だ傾向
主要吸附	主要だ吸着
主要感染	もたらす主だ感染	主だ感染
主要模式	主要だ模式
主要模式种	主要だ模式種
主要渔业	主要だ漁業
主要渔业生产	主要だ漁業生産
主要渔业生产地区	主要だ漁業生産地域
主要种类	主要だ種
主要种类对	主要だ種対
主要结构	主要だ構造
主要进展关系	係わる主要だ進歩
主要进步	主要だ進歩
主要部分	主要だ部
主要部分旋转	主要だ部回転	主要だ部回転変だ
主要部分旋转变流机	主要だ部回転変だ流機
主要部分旋转流动	主要だ部回転変だ流
主要酵母	主として酵母	主だ酵母
主要酵母细胞	主だ酵母細胞
主要酵母细胞悬浮	主だ酵母細胞懸濁
主要酵母细胞悬浮液	主だ酵母細胞懸濁液
主要钾	主だカリウム
主要钾气体	主だカリウムガス
举止	物腰
乌干达	ウガンダ
乙型肝炎	B型肝炎
乙基	エチル
乙烯基	ビニル
乙烯目标	ビニルターゲット
乙腈	アセトニトリル
乙酰胆碱	アセチルコリン
乙酰胆碱酯酶	アセチルコリンエステラーゼ
乙酰胆碱酯酶活性	アセチルコリンエステラーゼ活性
乙醇	エタノール
乙醇提取	エタノール抽出
乙醇提取物	エタノール抽出物
习惯	習慣
书	書
乱	乱
乳制品	乳製品
乳头	乳頭
乳头高	乳頭高
乳头高度为	乳頭高いさが
乳油	EC
乳清	ホエー
乳清蛋白	ホエー蛋白	ホエー蛋白質
乳清蛋白溶液	ホエー蛋白質溶液
乳清蛋白表面	ホエー蛋白質表面
乳白色	乳白色
乳腺	乳
了	する事	するする
了墙面	する壁面
了墙面函数	する壁面関数
了墙面函数边界	する壁面関数境界
了数值模拟	数値シミュレーションする
事	事
事实	いう事実	事実
事故	事故
事项	する事
二	II
二极管	ダイオード
二极管阵列	ダイオードアレイ
二极管阵列检测	ダイオードアレイ検出
二极管阵列检测器	ダイオードアレイ検出器
二氧化碳	CO
二氧化钛涂层	チタニア被覆
二甲苯酚	キシレノール
二甲苯酚橙	キシレノールオレンジ
互相关	相互相関
井	井
亚单位	サブユニット
亚热带	亜熱帯
交叉	クレード	クロス	交差
交叉杂交	クロスハイブリダイゼーション
交叉皮	交差皮
交叉皮层	交差皮層
交叉皮层模型	交差皮層モデル
交易	取引
交易依赖	取引依存
交流	交流
交流传输	交流伝送
交流传输方式	交流伝送方式
交通	交通
交通事故	交通事故
交通流	交通流
产业	業	産業
产业基础	産業基盤
产业开发	産業開発
产品	生産物	産品	製品
产品差别	製品差別
产品系统	産品システム
产权	所有権
产物	産物
产生	よって生じる	生じる	生む	生む出す	産	産生
产生的	おいる発生する
人	ヒト	人
人们所知的Mie	Mie
人工	人工
人工开口	人工開口
人工开口部	人工開口部
人工开口雷达	人工開口部ライダー
人工神经	人工神経
人工神经电路	人工神経回路
人工神经网络	人工神経回路網
人民	人民
人民医院	人民病院
人物	人物
人物理学	人物理学
人端粒酶	ヒトテロメラーゼ
人端粒酶催化	ヒトテロメラーゼ触媒
人端粒酶催化亚基	ヒトテロメラーゼ触媒サブユニット
人类	人間
介电	誘電
介电上升	誘電上昇
介电光谱	誘電スペクトル
介电参数	誘電パラメータ
介电行为	誘電挙動
介绍	する紹介	紹介
介绍了	紹介する
介绍的	紹介できる
介质	媒質
介质模型	媒質モデル
介质理论	媒質理論
仍	まだ
仍然支配	まだ支配
从事	従事	従事する
从而	従って
从而油母页岩	従ってオイルシェール
他	彼
付	付く
代表	代表
代谢	代謝
令	令
令幼体	令幼生
以BP电路	BP回路
以BP网络	BP回路網
以BP网络应用	BP回路網適用
以下	以下
以及不同	また異なる
以及不同叶片偏转角	また異なる翼偏向角度
以及不同机翼	また異なる翼
以及不同机翼偏向	また異なる翼偏向
以太	イーサ
以太网	イーサネット
以来	亘る
以来实施	亘る実施	亘る実施する
价	価
价格	価格
任意	いずれ	任意だの
任意高炉	任意だ高炉
仿真	シミュレーション
仿真模型	シミュレーションモデル
仿真波动	シミュレーション波動
仿真波动场	シミュレーション波動場
仿真波动场特性	シミュレーション波動場特性
企业	企業	企業体	型企業
企业内部	企業内部
企业内部构成	企業内部構成
企业内部构成辅助	企業内部構成補助
企业内部构成辅助物	企業内部構成補助物
企业成长	企業成長
企业特征	企業特徴
企业管理	企業統治
企业管理评价	企業統治評価
企业管理评价系统	企業統治評価システム
优先	優先
优先权	先取り特権
优势	優位だ
优异	対する優れる
优点	利点
优秀	優れる
优良电催化	優れる電気触媒
优良电催化活性	優れる電気触媒活性
优良电气	優れる電気
优良粘性	優れる粘性
会合	会合
传导	伝導
传播	伝搬	伝播
传播算法	伝搬アルゴリズム
传播高温	伝搬高温
传播高温合成	伝搬高温合成
传热	伝熱
传热特性	伝熱特性
传热特性预测	伝熱特性予測
传统	伝統
传输模型	伝送モデル
传达	伝達
传送	伝送	伝送する
传送摩擦	伝送する摩擦
传送方式	伝送方式
传送速度	伝送速度
传递函数	伝達関数
传递原理	伝達原理
传递特性	伝達特性
伤	傷
伤口	傷口
伤害	傷害
伤害特别是	傷害特に
伤害特别是交通	傷害特に交通
伤害特别是交通事故	傷害特に交通事故
伪	偽
伪操作	偽操作
伪操作群	偽操作群
伯特兰德	バートランド
伴随	伴う
但	かかわら
位	ビット	位
位相结构	位相構造
位系统	ビットシステム
位置	位置
位置混合	位置ハイブリッド
位置混合形成	位置ハイブリッド形成
位置监测	位置モニタ
低	低い
低乳	より低い乳
低乳头	より低い乳頭	低い乳頭
低乳头高	低い乳頭高
低乳腺	低い乳
低于	より低い
低观光	低い観光
低观光参与度	低い観光関与度
低观光相关	低い観光関与
低负债	低い負債
低速	低速だ
低速波	低速だ波
低高	低い高
低高对乳头	低い乳頭高いさが
住院	入院
体	ボディ	ボディー	体
体像	ボディーイメージ	ボディーイメージ障害
体像自我评价	ボディーイメージ障害自己評価
体像障碍自评量表	ボディーイメージ障害自己評価スケール
体液	体液
体积	体積
体积加法	体積加法
体积加法理论	体積加法理論
体积法	体積法
体系	体系
体腔	体腔
体腔细胞	体腔細胞
体腔细胞培养	体腔細胞培養
体腔细胞培养条件	体腔細胞培養条件
作业	作業
作业台	作業台
作业过程	作業過程
作用	作用	作用する	役割	役立つ
作用因素	作用する因子
作用机制	作用機構
作者	著者
作者科	著者科
使用	する使用	する使用さ	する使用する	する用いる	使う	使わ	使用	使用さ	使用する	使用できる	用いる	用いる行く
使用ASE	ASE
使用CCT	CCT
使用一种	用いる一種
使用介电	用いる誘電
使用介电光谱	用いる誘電スペクトル
使用决定	用いる決定する
使用副本	用いるレプリカ
使用同步	用いる同期
使用同步发电	用いる同期発電
使用同步发电机	用いる同期発電機
使用处理	用いる扱う
使用复制成形	用いるレプリカ成形
使用延迟	使う遅れる
使用检查	使用する検査	使用する検査する
使用检测	用いる検出する
使用的违法	よる違法だ使用
使用调查	使用する調査	使用する調査さ	用いる調査する
使用过程	使用するプロセス
使用进一步	用いるさらだ
使用进一步实验	用いるさらだ実験
使用高度	用いる高度
使用鼠标	用いるマウス
例	例	取るあげる
例全部	例すべて
例如	例えば
例如年龄	例えば年齢
例患者	例患者
例证	例証
例题	例題
供水	水供給
供电选择	電力供給選択
供给	供与する	供給
供给选择	供給選択
依次	次々
依次皮下	次第に皮下
依赖	依存	依存する
依赖样式	依存様式
侧面	側面
侵蚀	侵食
侵蚀过程	侵食プロセス
促性腺激素	性腺刺激ホルモン
促性腺激素释放	性腺刺激ホルモン放出
促进	促進	促進する
促进光	促進光
促进光分解	促進光分解
促进光分解二甲苯酚	促進光分解キシレノール
促进光分解二甲酚橙	促進光分解キシレノールオレンジ
促进相关	促進する相関
促进相关免疫	促進する相関免疫
促进相关免疫效应	促進する相関免疫エフェクター
促进相关免疫效应分子	促進する相関免疫エフェクター分子
保存	保存	温存
保存剂	保存料
保存插入	温存挿入
保护	よって保護	よって保護さ	保護	保護さ	保護できる
保护技术	保護できる技術
保持	保た	保つ	保持
保持体	保持体
保证	保証	保証する
信号	シグナル	信号
信号功率	信号パワー
信号对	シグナル対
信号对干扰	シグナル対干渉
信号对干扰加	シグナル対干渉プラス
信号对干扰加噪声	シグナル対干渉プラスノイズ
信号对干扰加噪声比损失	シグナル対干渉プラスノイズ比率損失
信号对干扰加噪声比率	シグナル対干渉プラスノイズ比率
信息	情報
信息技术	情報技術
信息整合	情報統合
信息综合平台	情報統合プラットフォーム
信赖	信頼
信道	チャネル
信道雷达	チャネルレーダ
信道雷达系统	チャネルレーダシステム
修改了	つく見直す
修正	修正	修正する	補正
修正重要	修正する重要だ
修正重要因素	修正する重要だ因子
修理	修理
修饰	修飾
修饰玻璃	修飾ガラス
修饰玻璃状	修飾ガラス状
修饰玻璃状碳	修飾ガラス状炭素
修饰玻碳电极	修飾ガラス状炭素電極
修饰电极	修飾電極
候补	候補
债权	債権
值	する値	値
值变分	値変分
值变分包含	値変分内包
值范围	値範囲
值解决	値解決
值解决方法	値解決法
倾向	傾向
倾斜	傾斜
假定	仮定	仮定する
假想	仮想
假想内窥镜	仮想内視鏡
假设	仮説
偏	する偏	偏
偏位	偏位
偏向	偏向
偏向角度	偏向角度
偏差	する偏差	偏差
偏移	オフセット
做饭	炊事
停工	ロックアウト
停止	停止	停止する	止める
停止动机	停止する動機
健康	健康だ
健康危险	健康だ危険だ
健康的	おける健康だ	おける健康だ関連
健康相关	健康だ関連
健康相关生活质量	健康だ関連クオリティオブライフ
健康相关的生活质量	おける健康だ関連クオリティオブライフ
健康调查	健康だ調査
储层	貯留層
催化亚基	触媒サブユニット
催化作用	触媒作用
催化剂	触媒
催化剂平均	触媒平均
催化剂平均粒	触媒平均粒
催化剂平均粒度	触媒平均粒度
催化氧化	触媒酸化
催化活性	触媒活性
元素	素子
充分	つく十分だ	十分だ
充分地方	十分だ地方
充分服务	十分だサービス
充分服务设备	十分だサービス設備
充分讨论	つく十分だ検討	つく十分だ検討する	十分だ検討	十分だ検討する
先	先
光	光
光传输	光透過
光催化剂	光触媒
光催化氧化	光触媒酸化
光催化活性	光触媒活性
光光度法	光光度法
光分析	光分析
光分析法	光分析法
光分解	光分解
光分解二甲苯酚	光分解キシレノール
光分解二甲苯酚橙	光分解キシレノールオレンジ
光器	光器
光学	光学
光学吸收	光学吸収
光学吸收特性	光学吸収特性
光度	光光度	光度
光度法	光度法
光度角度	光度角度
光接触	光接触
光接触氧化	光接触酸化
光接触氧化并用	光接触酸化併用
光接触氧化并用过程	光接触酸化併用プロセス
光束	ビーム
光漏斗	光漏斗
光电子	光電子
光电子能谱	光電子分光法
光纤	ファイバ
光纤放大	ファイバ増幅
光纤放大器	ファイバ増幅器
光纤端	ファイバ端
光线	光線
光线跟踪	光線追跡
光线跟踪算法	レイトレーシングアルゴリズム
光线追踪	レイトレーシング
光网络	光ネットワーク
光网络单元	光ネットワークユニット
光聚光	光集光
光聚光器	光集光器
光谱	するスペクトル	スペクトル	分光法
光谱分析	分光分析
光谱分析法	分光分析法
光集	光集
克服	克服	克服する
克維拉	ケブラー
克隆	クローン
克隆库	クローンライブラリ
克隆库分析	クローンライブラリ分析
免疫	免疫
免疫效应分子	免疫エフェクター分子
免疫效应器	免疫エフェクター
免疫状态	免疫状態
免疫调节	免疫調節
免疫调节机	免疫調節機
免疫调节机制	免疫調節機序
兔	ウサギ
入射	入射
入射角	入射角
入射角条件	入射角条件
全	フルだ
全员	全員
全文本	フルだテキスト
全文本搜索引擎	フルだテキスト検索エンジン
全文本检索	フルだテキスト検索
全部	全て
全部强	全て強い
全部强不稳定	全て強い不安定だ
全部强不稳定条件	全て強い不安定だ条件
公司	する会社	会社
公园	公園
公布	公表
公布文献	公表文献
公式	公式	式
共同	共	共同
共同景观	共通だ景観
共同景观格局	共通だ景観パターン
共同景观格局指标	共通だ景観パターン指標
共同的	共通の
共同设计	共同設計
共同设计最优	共同設計最適だ
共聚焦	共焦点
共聚焦显微	共焦点顕微
共聚焦显微镜	共焦点顕微鏡
共识	コンセンサス
共谋	共謀	共謀する
共谋许可	共謀するライセンス
关于	つく	関す
关于包括	関す包括
关于大量	関する大量だの
关于室外	つく屋外
关于节能	関する省エネルギー
关于表达	つく表現	つく表現する
关心	関心
关注	注目	注目さ
关系	係わる	関係	関係する
关系主要	係わる主要だ
关系指数	関係指数
关联	関連づける
关键	キー
关键单元	キーユニット
关键单元组	キーユニットセット
关闭	オフ	閉鎖
关闭网格	オフグリッド
关闭网格风	オフグリッド風
关闭网格风输出产业	オフグリッド風出力産業
关闭输出基础网格风	オフグリッド風出力基盤
关闭输出开发网格风	オフグリッド風出力開発
关闭输出网格风	オフグリッド風出力
其中	そのうち
其他	その他	他
其次	次に
其次关键单元组	次にキーユニットセット
其次增加	次に増加	次に増加する
其次序列	次に配列
其次序列分析	次に配列解析	次に配列解析する
其次接触	次に接触
其次接触比率	次に接触比率
其次综合	次に総合
其次缓慢	次にゆっくり
其次缓慢减少	次にゆっくり減
其次键	次にキー
其次键单元	次にキーユニット
具体	具体
具备扫描	備える走査
具备扫描电子	備える走査電子
具备扫描电子显微	備える走査電子顕微
具备扫描电子显微镜	備える走査電子顕微鏡
具有	もつ
具有变更	有する変更
具有对	もつ対
具有对于LDPE	もつLDPE
具有对于LDPE膜	もつLDPE膜
具有的Bi	有するBi
具有石墨层	もつ黒鉛層
具有类似有机物质	有する類似有機物質
具有网络	もつネットワーク
具有网络控制	もつネットワークコントロール
具有网络控制系统	もつネットワークコントロールシステム
具有能够持久耐用品	有する長続きする耐久財
具有黑铅	もつ黒鉛
典型	典型
内侧	内側
内侧转弯流路	ターン流路内側
内外	内外
内容	コンテンツ
内涵	内包
内科	内科
内科疗法	内科療法
内窥镜	内視鏡
内膜	内膜	内膜症
内膜上皮	内膜上皮
内膜上皮细胞	内膜上皮細胞
内膜症患者	内膜症患者
内膜细胞	内膜細胞
内膜细胞凋亡	内膜細胞アポトーシス
内部	インター	内部
内部构成	内部構成
内部构成辅助	内部構成補助
内部构成辅助物	内部構成補助物
再现	再現
再现性能	再現性能
再现的	する再現
再生	再生
再生的	再生する
军事	軍事
军队	軍隊
农业	農業
农业防治	農業退治
冲击	衝撃
冲击声辐射	衝撃音響放射
冲击声辐射信号	衝撃音響放射信号
冲击实验	衝撃実験
冲击音响	衝撃音響
决定	決める	決定	決定さ	決定する	用いる決定
决定着	着る決定
冶金	冶金
冶金行业	冶金業
冷却	冷却	冷却流
冷却变态	冷却変態
冷却板	板冷却
冷却水流	冷却水流
冷却水流量	冷却水流量
冷却流路	冷却流路
冷却策略	冷却戦略
冷却路径控制	冷却流路制御
冷却路径控制方式	冷却流路制御方式
冷却路径管理	冷却流路管理
冷却过程	冷却過程
冷空气	寒気
冷锋	寒冷だ前線
准备	準備	準備する
准确	正確だ
凋亡	アポトーシス
凋亡相关	アポトーシス関連
凋亡相关机制	アポトーシス関連機構
凋亡相关蛋白	アポトーシス関連タンパク	アポトーシス関連タンパク質
凋亡程度	アポトーシス度
凋亡细胞	アポトーシス細胞
减少	より減少	分減少	減	減らす	減少	減少さ	減少し	減少する
减少减弱	減少する弱まる
减弱	弱まる
减弱的	する弱まる
减排	排出削減
减法	減算
减法运算	減算する
减轻	軽減	軽減する
凝固	凝固
凝固变换	凝固変換
凝固试验	凝固試験
几乎	ほとんど	ほぼ
几乎相同	ほぼ同一だ
几何	幾何
出	出す
出现	出現	現れる
出血	出血
出血热	出血熱
出院	退院	退院する
出院在SAP	退院するSAP
函子	クター
函数	関数
函数因子	関数因子
函数峰值	関数ピーク
函数条件	関数条件
函数边界	関数境界
函数边界条件	関数境界条件
刀片	ブレード
刀片流动	ブレード流
刀片流路	ブレード流路
刀片流路内侧	ブレード流路内側
分	分
分光	分光
分光光度	分光光度
分光光度法	分光光度法
分减少	分減少する
分别	それぞれ	別々だの	別だ
分别分析	別だ分析	別だ分析する
分别评价	それぞれ評価	それぞれ評価さ
分别静脉	それぞれ静脈
分割	分割	分割さ	分割する	割り当てる
分割处理	分割する処理	分割する処理する
分割法	分割法
分子	分子
分子机制	分子機構
分子标记	分子標識
分子标记在HSP	分子標識HSP
分子流行病学	分子疫学
分子流行病学分析	分子疫学分析
分子硫酸	分子硫酸
分子种	分子種
分布	分布
分布模式	分布パターン
分开	分ける
分式	分式
分散	分散
分散X射线	分散X線
分散X射线分	分散X線分
分散X射线分光	分散X線分光
分散X射线分光分析	分散X線分光分析
分散信息	分散情報
分散信息整合	分散情報統合
分散信息综合平台	分散情報統合プラットフォーム
分散效果	分散効果
分数	分数
分数常	分数常
分数常微分	分数常微分
分数常微分方程	分数常微分方程式
分析	つく解析	つく解析する	より分析	より分析する	分析	分析する	解析	解析する	量解析
分析仪器	分析機器
分析数据	解析データ
分析模型	解析モデル
分析法	分析法	解析法
分离	よる分離	分離	分離する	単離	単離する	離れる
分离方式	よる分離方式	分離方式
分离的	分離する
分离纯化	分離精製
分离翼	分離する翼
分类	分類	分類さ
分解	分解	分解する
分解二甲苯酚	分解キシレノール
分解二甲苯酚橙	分解キシレノールオレンジ
分解产物	分解生成だ物
分解模式	分解モード
分解焓	分解エンタルピー
分解特性	分解特性
分解生成	分解生成だ
分解速度	分解速度
分辨	分かる
分辨率	分解能
分阶段BAF	段階BAF
分馏	分画
切开	切開
切换	切換
切换配电	切換配電
切换配电系数	切換配電係数
切除术	摘出術
列	列
创伤	創	創傷
创新	イノベーション	革新
创新技术	革新技術
创新技术度	革新技術度
创生	創生
创生网络	創生ネットワーク
初次	初めて
初级实验	プライマリ実験
初级实验组	プライマリ実験群
初级的	おけるプライマリ
判定	判定
判定标准	判定基準
判断	判断	判断する
判明	判明	判明する
利用	する利用	する利用できる	利用	利用さ	利用する	利用できる
利用CFD	CFD
利用DNA	DNAミクロ
利用模式	利用パターン
到期	満期
到期构成	満期構成
到期资产	満期資産
到达	到達	到達する
制作	よって作ら	作ら	作る	作成	作製	作製する
制作方式	作成方式
制剂	剤
制法	製法
制造	製造	製造さ	製造する
制造工业	製造工業
刺激	刺激
刺激素	刺激ホルモン
剂浓度	剤濃度
剂量	投与量	投薬量
削减	削減
削减创新	削減イノベーション
削减替代	削減代替
削减替代创新	削減代替イノベーション
削球	カッティング
前后	する前後	前後
前提	前提
前提条件	前提条件
前线	前線
前进	フォワード
前馈	フィードフォワード
前馈神经	フィードフォワード神経	フォワード神経
前馈神经回路	フィードフォワード神経回路	フォワード神経回路
前馈神经网络	フィードフォワード神経回路網	フォワード神経回路網
剖面	プロファイル	プロフィール
剪切	剪断
副本	レプリカ
副本成形	レプリカ成形
力	力
力学	力学
力学参数	力学パラメータ
力性能参数	力性能パラメータ
力性能实验	力性能実験
力性能曲线	力性能曲線
力设计	力設計
功率	パワー
功率电子	パワー電子
功率电子器件	パワーエレクトロニクス素子
功率电子学	パワーエレクトロニクス
功率电子构建	パワー電子構築
功率电子构建块	パワー電子構築ブロック
功率电子设备	パワーエレクトロニクス機器
功率管理	パワーマネージメント
功率集成电路	パワーIC
功能	機能
功能材料	機能材料
功能材料群	機能材料群
加上	加えて
加入	加える
加合物	付加物
加合物曲线	付加物曲線
加噪声	プラスノイズ
加噪声比率	プラスノイズ比率
加工	加工	加工さ
加工方法	加工法
加工法改良	加工法改良
加法	加法
加法理论	加法理論
加深	深める
加热	加熱
加热倾斜	加熱傾斜
加热速度	加熱速度
加载	ローディング
加载样本	ローディングサンプル
加载样本密度	ローディングサンプル密度
加速	加速	加速する
加速器	アクセル
动	動
动力	動力
动向	動向
动态	ダイナミックだ	動的だ
动态发烟	動的だ発煙
动态发烟模拟	動的だ発煙シミュレーション
动态性能	動的だ性能
动态格局	動的だパターン
动态特性	動特性
动态范围	ダイナミックだレンジ
动态衰减	動的だ減衰
动态试验	動的だ試験
动态试验方法	動的だ試験方法
动机	する動機	動機
努力	努力	努力する
包含	含む
包含分子	含む分子
包含囊肿	含む嚢胞
包含自然	含むナチュラルだ
包装	パッケージ
化合物	化合	化合物
化合物培养基	化合物培地
化学	よる化学	化学
化学产业	化学産業
化学平衡	よる化学平衡	化学平衡
化学组成	化学組成
化学试剂	化学試薬
化学防治	化学退治
化脓	化膿
北京	北京
北京昌平(西燕)	北京昌平
北京昌平区	北京昌平区
北部	北部
匹配不合并	対す不都合だ
区	区
区分	区分	区分け
区分方案	区分案
区域	エリア	ゾーン	区域	域
区域搜索	域探索
区域搜索能力	域探索能力
区域方式	領域方式
区域的	よる区域
区域积分	領域積分
区域积分方式	領域積分方式
区疾病	区疾病
区疾病预防	区疾病予防
区疾病预防控制中心	区疾病予防管理センター
区疾病预防管理	区疾病予防管理
区间	区間
医科	医科
医科大学	医科大学
医科大学附属	医科大学付属
医科大学附属盛京	医科大学付属盛京
医科大学附属盛京医院	医科大学付属盛京病院
医院	病院
医院记录	病院記録
十进制的	南進する
升力	揚力
升级	アップ	レベルアップ
升高	より上昇する
半	半
半可逆	半可逆
半导体	半導体
协同作用	相乗作用
协同效应	相乗効果
协调	協調
卓越	卓越
卓越的	卓越する
单	単
单一	単一だ
单一MAO	単一だMAO
单一MAO方式	単一だMAO方式
单一的	単一だの
单一碳	単一だ炭素
单一碳源	単一だ炭素源
单位	単位
单侧	片側
单元	ユニット
单元组	ユニットセット
单射	単射
单射性腺	単射性腺
单射性腺刺激	単射性腺刺激
单射性腺激素	単射性腺刺激ホルモン
单射性腺激素释放	単射性腺刺激ホルモン放出
单方	片方
单核苷酸	単一だヌクレオチド
单核苷酸多	単一だヌクレオチド多
单根	単根
单独	単独
单纯	単純だ
单纯囊肿	単純だ嚢胞
南	南
南平	南平
南进	南進
占	占める
卡比特	カービー
印刷	プリント
印度	インド
印迹	イン
危险	危険だ
即	すなわち	つまり	即ち
卷	巻
历史	史	歴史
压力	圧力
压力损失	圧力損失
压力机	プレス
压力机的	プレスする
压力范围	圧力範囲
压缩	圧縮
压裂液	破砕液
厌氧	嫌気
原	原
原位	原位置
原位杂交	原位置ハイブリッド	原位置ハイブリッド形成
原发性	原発
原因	原因
原始	オリジナルだ	原始
原始指纹	オリジナルだフィンガー	オリジナルだフィンガープリント
原始的	オリジナルだの
原始通量	オリジナルだフラックス
原始通量密度	オリジナルだフラックス密度
原始通量密度波形	オリジナルだフラックス密度波形
原始通量密度波形扭曲	オリジナルだフラックス密度波形歪
原料	原料
原材料	原材料
原材料比	原材料比
原理	原理
厨房	炊事場
去除	取り除く	除去	除去する
去除性能	除去する性能
县	県
参与	関与
参与度	関与度
参数	パラメータ
参数估计	パラメータ推定
参照	参照
参照结果	参照結果
及	及ぶ
双	バイナリー
双基因	バイナリー遺伝子
双层双头	従って二重シュル
双层模型	二重シュルモデル
双层流动	二重シュル
双层相关模型	従って二重シュルモデル
双方	両方	双方
双重	二重
双重标记	二重標識
反向传播	逆だ伝搬
反向传播算法	逆だ伝搬アルゴリズム
反复	反復
反复基因杆菌属	クター属反復遺伝子
反复杆菌属	クター属反復	ロバクター属反復
反复检测	反復検出
反对态度	反対だ態度
反射	反射
反应	反応
反应次	反応次
反应速度	反応速度
反应速度参数	反応速度パラメータ
反式	トランス
反映	反映	反映する
反映到	反映する
反馈纹理	くフィード
发动机	エンジン
发展	なる発展	発展	発展する
发展各种系统结构	発展する各種構造系
发展各种结构	発展する各種構造
发泡	発泡
发泡过程	発泡過程
发烟	発煙
发烟仿真模型	発煙シミュレーションモデル
发烟模拟	発煙シミュレーション
发烟的	する発煙
发烟的仿真模型	する発煙シミュレーションモデル
发热	発熱
发现	みる	わかつ	発見	発見さ	発見できる
发生	おいる発生	発生	発生さ	発生する
发生周期	発生周期
发生年龄	発生する年齢
发生的	発生する
发生的SO	おいる発生するSO	発生するSO
发生骨折	発生する骨折
发电	発電
发电厂	発電所
发电机	発電機
发电机设计	発電機設計
发病	発病	発病する	発症
发病率	有病率
发病部位	発病部位
发育	発育
发达	発達	発達する
发达的事	発達する事
发酵	発酵
发酵过程	発酵過程
取	取る
受	浴びる
受力性能	力性能
变	なり	変だ
变分	変分
变分包含	変分内包
变动	変動
变动法则	変動法則
变化	バリエーション	変化	変化する
变化传送	変化する伝送
变化传送速度	変化する伝送速度
变化形状	変化形状
变化形状设计	変化形状設計
变化规律	変化規則
变化随机延迟	変化ランダム遅延
变态	変態
变换	変換
变更	変更	変更さ
变流	変だ流
变流机	変だ流機
变种	変種
变量	一変量	変数
变量最优	変数最適だ
变量模式	変数モード
叙述	述べる
口服	経口
口服给药	経口投与
古典	古典
另	もう
另一方	もう片方
另外	また
另外作者	また著者
可	可
可以	できる	よく同調
可以介绍	する紹介できる
可以使用	使用できる
可变	可変だ
可变块	可変だブロック
可变块尺寸	可変だブロックサイズ
可干扰	可干渉
可恢复	回復できる
可持续	持続可能だ
可持续开发	持続可能だ開発
可能	可能だ
可能安全	可能だ安全だ
可能开发	可能だ開発
可能的	よる可能だ
可能的安全	よる可能だ安全だ
可能的安全问题	よる可能だ安全だ問題	可能だ安全だ問題
可逆	可逆
台	台
叶	葉
叶提取物	葉エキス
叶类型	葉タイプ
叶类型断面	葉タイプ断面
叶类型断面几何	葉タイプ断面幾何
各个	個々	各々
各向异性	異方性
各向异性介质	異方性媒質
各种	する各種	各種	様々だ種類	種々だの
各种中央	種々だ中央
各种中央周波	種々だ中央周波
各种供电	種々だ電力供給
各种入射	種々だ入射
各种入射角	種々だ入射角
各种入射角条件	種々だ入射角条件
各种发展	発展する各種
各种各样	様々だ
各种各样的	様々だの
各种地区	様々だ地区
各种山岳	種々だ山岳
各种山岳大概	概して種々だ山岳
各种所有	種々だ所有
各种所有权	種々だ所有権
各种技术	様々だ技術
各种模糊	種々だあいまいだ
各种模糊凹陷	種々だあいまいだノッチ
各种模糊触点位置	種々だあいまいだノッチ位置
各种油	種々だ油
各种油样	種々だ油試料
各种流体	様々だ流体
各种电力	種々だ電力
各种电力供给选择	種々だ電力供給選択
各种电器	様々だ電器
各种结构	する各種構造	各種構造
各种结构系统	する各種構造系	各種構造系
各种药物	様々だ薬物
各种药物抵抗	様々だ薬物抵抗
合	合
合并	合併
合并疼痛	合併痛む
合并轻微	合併軽微だ
合成	合成
合成的	合成する
合抛物面	合放物面
合抛物面聚光	合放物面集光
合抛物面聚光器	合放物面集光器
合抛物面集	合放物面集
合流	合流
合理	合理
合肥	合肥
合金	合金
合金表面	合金表面
同一	同一だ
同一个	それぞれ同じだ
同一个基因	それぞれ同じだ遺伝子
同一患者	同一だ患者
同时	ともに	同時	同時に
同时双方	同時に両方
同时增加	ともに増加する
同样	同様だ	同様だの
同样的方法	同様だ方法
同步	同期	同調
同步发电	同期発電
同步发电机	同期発電機
同步的	同調する
同源性	ホモロジー
后体腔	する体腔
后体腔细胞培养	する体腔細胞培養
后援	後押し	後押しする
后方	後方
后方泵	後方ポンプ
后方泵光纤	後方ポンプファイバ
后方泵光纤扩增	後方ポンプファイバ増幅
后方泵光纤放大器	後方ポンプファイバ増幅器
后进	後進
向	向かう
否	否
否定	否定	否定する
含	含む層
含自然杀伤	含むナチュラルだキラー
含量	含量
启动	プライ	稼動	稼動する
启动的	おけるプライ
吸光	吸光
吸光分光	吸光分光
吸光分光分析	吸光分光分析
吸收	より吸収	吸収	吸収さ
吸收光谱	吸収スペクトル
吸收光谱法	吸光分光分析法
吸收分	吸光分
吸收特性	吸収特性
吸收的	より吸収さ
吸附	吸着
吸附质	吸着質
吸附质树脂	吸着質樹脂
吸附质树脂剂	吸着質樹脂剤
呈现	呈す
周	周
周期	周期
周波	周波
周边	周辺
周边电路	周辺回路
周面	周面
周面摩擦	周面摩擦
呼叫	呼ぶ
呼吸	呼吸
呼吸循环	呼吸循環
呼吸循环功能	呼吸循環機能
咳嗽	咳
品质	品質
响应速度	応答速度
唯一	唯一
啤酒	ビール
啤酒发酵	ビール発酵
啤酒酵母	ビール酵母
喷出	噴出る
喷气	ジェット
器	器
器中央	器中央
器中央部	器中央部
器负荷	器負荷
噪声	ノイズ
噪声去除	雑音除去
噪声样本	ノイズサンプル
噪声比率	ノイズ比率
噪声比率损失	ノイズ比率損失
囊肿	嚢胞
回声	エコ
回归	回帰
回收	回収
回路	ループ
回转仪	ジャイロスコープ
回顾性研究	遡及研究
因	因
因子	因子
因感染	因感染
因此双	従って二重
因素	する因子	要因
因素影响	因子影響
园	園
困难	困難だ
围产期	周産期
围产期母子	周産期母子
固体	固体
固体成分	固体成分
固定	固定	定	定着
固定贯通	定常貫通
固定贯通过程	定常貫通過程
固定费用	固定料金
固定费用许可	固定料金ライセンス
固定速率	定常レート
固有原因	固有だ原因
固有特性	固有だ特性
固有界限	固有だ限界
固有的	固有だの
固相	固相
固相法	固相法
国内外	国内外
国家	国	国立
国家科学	国立科学
国家科学基金会	国立科学財団
国际	インターナショナルだ
国际期刊	インターナショナルだジャーナル
图	図
图像	イメージ	画像
图像障碍	イメージ障害
图像障碍自	イメージ障害自己
图像障碍自我评价	イメージ障害自己評価
图像障碍自评量表	イメージ障害自己評価スケール
图表	グラフ	チャート
图表利用	チャート利用
圆形	円形
圆形齿轮	円形ギア
圆柱	円柱
圆锥	円錐
圆锥补充	円錐補完
圆锥补充线性	円錐補完線形
圈闭	トラップ
土地	ランド	土地
土地利用	土地利用
土地生态	土地生態
土地生态区分	土地生態区分
土地生态规划	土地生態計画
土地覆盖	土地被覆
土壤	おける土地	土壌
土壤侵蚀	土壌侵食	土壌浸食
土壤侵蚀变量	土壌浸食変数
土壤侵蚀状况	土壌浸食状況
土壤侵蚀过程	土壌侵食プロセス	土壌浸食プロセス
土壤生态	おける土地生態
土壤生态规划	おける土地生態計画
在	おいる	おいるウサギ
在AA	AA
在AA基因	AA遺伝子
在AC	AC
在AC发电	AC発電
在AC发电机	AC発電機
在AC发电机设计	AC発電機設計
在AC模型	ACモデル
在AC电力	AC電力
在AC电力基础	AC電力ベース
在AC电力流动	AC電力フロー
在AC电力流程库	AC電力フローベース
在ADS	ADS
在AES	AES
在AG	AG
在ALT	ALT
在BOD	BOD
在Bi	Bi
在CEA	CEA
在DAD	DAD
在DC	DC
在DC功率流	DC電力フロー
在DC电力	DC電力
在DC电力流程库	DC電力フローベース
在DF	DF
在DF的	するDF
在FE	FE
在FPGA	FPGA
在FT	FT
在GDP	GDP
在GDP单位	GDP単位
在GP	GP
在GP带	GPゾーン
在HA	HA
在HCl	HCl
在HSP	HSP
在IC	IC
在ICP	ICP
在IEEE	IEEE
在KA	KA
在KB	KB
在LC	LC
在LM	LM
在LP	LP
在LS	LS
在MBR	MBR
在MH	MH
在MP	MP
在NS	NS
在NaOH	NaOH
在NaOH使用	NaOH使用
在OR	OR
在PA	PA
在PF	PF
在PF的	おけるPF
在PI	PI
在PI双	PI二重
在PI双标记	PI二重標識
在RP	RP
在SAP	SAP
在SBR	SBR
在SEM	SEM
在SS	SS
在SS的	おけるSS
在Si	Si
在UML	UML
在UML状态	UMLステート
在UML状态图	UMLステートチャート
在VAS	VAS
在XML	XML
在XML文本	XMLテキスト
在XML文本检索	XMLテキスト検索
在XRD	XRD
在下	する下
在中心	おいる中心
在冷却	おける冷却
在冷却流	おける冷却流
在冷却流路	おける冷却流路
在基础实验	おけるプライマリ実験
在多巴胺	おいるドーパミン
在时效	おける時効
在杰出	おいる傑出	おいる傑出する
在杰出性能	おいる傑出する性能
在耐用品	する耐久財
在证明	おいる立証
在调查	おいる調べる
在风	おいる風
在风输出	おいる風出力
在风输出产业	おいる風出力産業
在验证了	おいる立証する
地	地
地产品	地産品
地产品系统	地産品システム
地区	地区	地域
地区产物	地域産物
地区居民	地域住民
地形	地形
地形要素	地形要素
地方	地場	地方
地方旅游开发	地方観光開発
地方观光	地方観光
地球	地球
地球物理	地球物理
地球物理勘探	地球物理探査
地球规模	地球規模
场传播	場伝播
场所	場
场特性	場特性
坏死	壊死
坏死因子	壊死因子
块	ブロック
块分布	ブロック分布
块尺寸	ブロックサイズ
块携带	ブロックキャリー
块携带预读	ブロックキャリー先読む
坦桑尼亚	タンザニア
坪	坪
垂直	垂直だ	鉛直だ
垂直灵敏度	垂直だ感度
垂直积分	鉛直だ積分
垂直积分液	鉛直だ積分液
垂直积分液态水	鉛直だ積分液水
型特异性	型特異だ
型特异性引物	型特異だプライマー
埃里克	エリック
城	城
城市	城市	都市
城市环状	都市環状
城市环状总线	都市環状バス
培养	インキュベートする	培養	培養する
培养体腔	培養する体腔
培养体腔细胞	培養する体腔細胞
培养体腔细胞培养	培養する体腔細胞培養
培养体腔细胞培养条件	培養する体腔細胞培養条件
培养基	培地
培养处理	インキュベートする処理
培养处理细胞	インキュベートする処理細胞
培养条件	培養条件
基	酸基
基于	基づく
基于一般	基づく一般
基于使用的粒子	基づくパーティクルスウォーム
基于使用粒子群算法	基づくパーティクルスウォーム最適だ
基于光线跟踪	基づくレイトレーシング
基于光线跟踪算法	基づくレイトレーシングアルゴリズム
基于创新	基づく革新
基于功率流	電力フローベース
基于在AC电力输电	AC電力ベース送電
基于在AC电力输电权利	AC電力ベース送電権利
基于壁面	基づく壁面
基于壁面函数	基づく壁面関数
基于失真	基づくゆがむ
基于实时	基づくリアルタイム
基于应用的AC电力输电权利	AC電力ベース送電権利応用
基于扩增自然释放	基づく増幅自然放出
基于搜索的AC电力	探索するAC電力ベース
基于搜索的AC电力输电	探索するAC電力ベース送電
基于搜索的AC电力输电权利	探索するAC電力ベース送電権利
基于搜索的AC电力输电权利应用	探索するAC電力ベース送電権利応用
基于新方法	基づく新規だ方法
基于新的	基づく新規だ
基于最优	基づく最適だ
基于最优线性	基づく最適だ線形
基于最优线性滤波器	基づく最適だ線形フィルタ
基于权利的AC电力输电应用	するAC電力ベース送電権利応用
基于流	フローベース
基于电力	基づく電力
基于电力切换	基づく電力切換
基于电力切换配电	基づく電力切換配電
基于电力切换配电系数	基づく電力切換配電係数
基于电力输电权利应用	電力ベース送電権利応用
基于的AC电力输电权利	するAC電力ベース送電権利
基于相关	基づく相関
基于相关积	基づく相関積
基于系统	基づく系統	基づく系統樹
基于系统树分析	基づく系統樹分析
基于观察员	オブザーバーベース
基于软件	基づくソフト
基于软件阴影	基づくソフト陰影
基于软件阴影算法	基づくソフト陰影アルゴリズム
基于输电权利	ベース送電権利
基于输电权利应用	ベース送電権利応用
基于输电的AC电力	するAC電力ベース送電
基于颗粒	基づくパーティクル
基于高速	基づく高速だ
基因	遺伝子
基因分型	遺伝子タイピング
基因分型结果	遺伝子タイピング結果
基因外	遺伝子外
基因外复发	遺伝子外再発
基因检测	遺伝子検出
基因源	遺伝子源
基因组合	遺伝子コンビネーション
基因芯片	遺伝子チップ
基因表达	遺伝子発現
基因表达剖面	遺伝子発現プロフィール
基因频率	遺伝子頻度
基因频率分布	遺伝子頻度分布
基本	基本
基础	もと	プライマリ	ベース	基	基く	基づく	基盤	基礎
基础下部	基づく下部
基础下部结构	基づく下部構造
基础前馈	基くフィードフォワード
基础前馈神经	基くフィードフォワード神経
基础前馈神经回路	基くフィードフォワード神経回路
基础前馈神经网络	基くフィードフォワード神経回路網
基础因素	基盤因子
基础开发	基づく開発さ
基础扩增	基づく増幅
基础扩增自然	基づく増幅自然
基础新	基づく新しい
基础输电	ベース送電
基础馈电	基くフィード
基质	基質
基质溶液	質溶液
基质细胞	基質細胞
堤防	堤防
填充	フィル	充填
填充物	充填物
增加	ともに増加	増える	増加	増加さ	増加する	増加できる
增加渔民	増加する漁民
增大	伴う増大	伴う増大する	増大	増大さ	増大する
增幅	増幅する
壁	壁
壁函数	壁関数
壁面	壁面
壁面函数	壁面関数
壁面函数条件	壁面関数条件
壁面函数边界	壁関数境界	壁面関数境界
壁面函数边界条件	壁関数境界条件	壁面関数境界条件
声发射	AE
声发射模式	モードAE
声源	音源
声源位置	音源位置
声源定位	音源位置決める
声辐射	音響放射
声辐射信号	音響放射信号
处方	処方
处方设计	処方設計
处理	する処理	する処理する	より処理	より処理さ	処理	処理さ	処理する	扱う
处理器	プロセッサ
处理性能	処理パフォーマンス
处理水果	処理果物
处理系统	処理システム
处理细胞	する処理細胞	処理細胞
处理能力	処理能力
复制	よって複製	複製	複製する
复制的	よって複製する
复印	複写	複写する
复原	復元	復元する
复发	再発
复合	ある複合	複合
复合峰	複合ピーク
复合材料	複合材料
复合波	複合波
复合波结构	複合波構造
复合系统	複合システム
复合系统现象	複合システム現象
复合结构	複合構造
复合绝缘	ある複合絶縁	複合絶縁
复合绝缘物	ある複合絶縁物	複合絶縁物
复合诱饵	複合デコイ
复数	複数
复杂	用いる複雑だ	複雑だ
复杂体	複雑だボディ
复杂共同	複雑だ共同
复杂共同设计最优	複雑だ共同設計最適だ
复杂协同设计	複雑だ共同設計
复杂对象	複雑だ対象	複雑だ対象物
复杂度	複雑だ度
复杂的	する複雑だ
复杂系数	用いる複雑だ係数	複雑だ係数
复杂系统	複雑だ系	複雑だシステム
复杂背景	複雑だ背景
外	外
外伤	外傷
外伤史	外傷史
外吸收	外吸収
外吸收光谱	外吸収スペクトル
外国	外国
外复发	外再発
外差	ヘテロダイン
外差检波	ヘテロダイン検波
外来	外来
外源基因	外来遺伝子
外源基因源	外来遺伝子源
外科	外科
外科手术	外科手術
外过滤膜浓缩	外ろ過膜濃縮
外过滤膜浓缩技术	外ろ過膜濃縮技術
外部	外部
外部标准	外部標準
外部标准法	外部標準法
多	おけるマルチ	する多	マルチ	多	多い	多い報告さ
多义性	多義性
多价疫苗	価ワクチン
多体系	多体系
多光谱	多重スペクトル
多发	多発
多发性肋骨	多発肋骨
多发性肋骨骨折	多発肋骨骨折
多子带	おけるマルチサブバンド	マルチサブバンド	多重サブバンド
多子带提高	マルチサブバンド向上
多子带提高因子	マルチサブバンド向上因子
多子带时空	マルチサブバンド時空
多峰值	マルチピーク
多峰拟合	マルチピークフィッティング
多峰拟合法	マルチピークフィッティング法
多巴胺	ドーパミン
多巴胺含量	ドーパミン含量
多报告	多い報告
多振动	多い振動
多数	多数
多普勒	ドップラー
多样	多様だ
多样性	多様だ
多水平	多水準
多流体模型	多重流体モデル
多流体理论	多重流体理論
多流体高炉	多重流体高炉
多流体高炉模型	多重流体高炉モデル
多消费	多消費
多种景观	多様だ景観
多种景观指标	多様だ景観指標
多通道	マルチチャネル
多通道雷达	マルチチャネルレーダ
多通道雷达带宽	帯域マルチチャネルレーダ
多通道雷达系统	マルチチャネルレーダシステム
多重	多重
多重子带组	多重サブバンド組
多重子带重组	多重サブバンド組換える
多重流体	多重流体
多重高斯	多重ガウス
多重高斯函数	多重ガウス関数
多重高斯函数峰	多重ガウス関数ピーク
多阶段	多段階
多阶段识别	多段階識別
多阶段识别方法	多段階識別方法
大	より大きい	大いに	大きる	大きい
大众	大衆
大依赖	大きい依存	大きい依存する
大动态	より大きいダイナミックだ	大きいダイナミックだ
大动态范围	より大きいダイナミックだレンジ	大きいダイナミックだレンジ
大半	大半
大多	おいる多い
大大改善	大いに改善	大いに改善さ
大大改善了	大いに改善する
大学	大学
大学附属	大学付属
大学附属盛京	大学付属盛京
大学附属盛京医院	大学付属盛京病院
大楼	ビル
大楼电阻	ビル抵抗
大概	概して
大气	大気
大气校正	大気補正
大社会	大きい社会
大虫	大きい虫
大虫体	大きい虫体
大豆	大豆
大豆异黄酮	大豆イソフラボン
大量	多量だの	大量だ	大量だの
大量Ca离子	多量だCaイオン
大量关注	多量だ注目
大量挥发	大量だ揮発
大量挥发物	大量だ揮発物
大量的	おける大量だ
大量资源	大量だ資源
大量钙	多量だCa
大量风力	大量だ風力
大量风力能源	大量だ風力エネルギー
大铁	大きいFe
大鼠	よってラット	ラット
大鼠模型	よってラットモデル	ラットモデル
天冬氨酸	アスパラギン酸
天冬氨酸基	アスパラギン酸基
天冬氨酸转移	アスパラギン酸基転移
天冬氨酸转移酶	アスパラギン酸基転移酵素
天冬酰胺	アスパラギン
天气	天気
天然气储层	ガス貯留層
天电	空電
太阳	太陽
太阳光	太陽光
太阳光漏斗	太陽光漏斗
太阳能聚光	太陽光集光
太阳能集	太陽光集
太阳能集中器	太陽光集光器
头	頭
头痛	頭痛
头皮	頭皮
头部	頭部
头高	頭高
奇异	特異だ
女性	女性
好	好例
如果	なら	もし
如果合并	もし合併
如果并发症	もし合併症
妊娠	妊娠
妥当	妥当だ
妥当改革	妥当だ改革
妥当改革计划	妥当だ改革計画
姿势	姿勢
威胁	脅す
威胁程度	脅す程度
媒介	媒介
媒体	媒体
子	子
子宫	子宮
子宫内膜	子宮内膜
子宫内膜上皮	子宮内膜上皮
子宫内膜上皮细胞	子宮内膜上皮細胞
子宫内膜异位症	子宮内膜症
子宫内膜异位症患者	子宮内膜症患者
子宫内膜细胞	子宮内膜細胞
子宫内膜细胞凋亡	子宮内膜細胞アポトーシス
子带	サブバンド
子带上升	サブバンド向上
子带提高因子	サブバンド向上因子
子带时空	サブバンド時空
子带组	サブバンド組
子带重组	サブバンド組換える
子弹	弾丸
子模拟	子シミュレーション
子点	子ドット
子系统	サブシステム
子计算	子コンピューティング
子计算机	子コンピュータ
孔径	細孔径
孔径分布	細孔径分布
孔隙	細孔
孕妇	妊婦
字	字
存储区域	貯蔵エリア
存储器	メモリー
存在	ほとんど存在	ほとんど存在する	存在	存在する
孢子	胞子
学问	学問
学问领域	学問領域
孵化	インキュベーション	インキュベート
它前馈神经	くフィードフォワード神経
守护	守る
安全	安全だ
安全管理	安全だ管理
安全问题	安全だ問題
安徽	安徽
安息	安息
安息香	安息香
安慰剂	プラセボ
安慰剂溶液	プラセボ溶液
完全	よって完全だ	全く	完全だ
完全一致	ぴったり一致	ぴったり一致する
完全关系	全く関係	全く関係する
完全去除	よって完全だ除去	よって完全だ除去さ	完全だ除去	完全だ除去さ
完全惩治	完全だ退治する
完全没有	全くない
完全防治	完全だ退治
完整	インタクト
完美	完璧だ
完美风景	完璧だ風景
完美风景指标	完璧だ風景指標
定位	位置決める
定位精度	位置決める精度
定制	カスタム
定性	定性的
定期	定期
定量	定量
定量下限	定量下限
定量法	定量法
定量界限	定量限界
实情	実情
实效	実効
实施	実施	実施さ	実施する
实时	リアルタイム
实测	実測
实测值	実測値
实现	実現	実現さ	実現する	実現可能だ
实现区域	実現可能だ領域
实现手续	実現手続き
实现方案	実現する案
实用	実用
实行	実行する
实证	実証
实际	より実用	実利	実際
实际收入	実効所得
实际特性	実際特性
实验	する実験	実験
实验室	する実験室	実験室	実験室スケール
实验室的	する実験室スケール
实验数据	する実験データ	実験データ
实验数据曲线	する実験データ曲線	実験データ曲線
实验曲线	実験曲線
实验组	実験群
实验结果	する実験結果	実験結果
审查	レビュー
室	室
室内尺度	室スケール
室外	屋外
室温	室温
室温冷却	室温冷却
家庭调查	家族調査
家族	家族
容易	容易だ
容积	容積
容积浓度	容積濃度
容量	容量
宽带	広帯域
宽带多	広帯域マルチ
宽带多通道	広帯域マルチチャネル
宽带多通道雷达	広帯域マルチチャネルレーダ
宽带多通道雷达系统	広帯域マルチチャネルレーダシステム
密度	密度
密度波形	密度波形
密度波形扭曲	密度波形歪
密度特性	密度特性
密度聚乙烯	密度ポリエチレン
密度集成	密度集積
密闭	密閉
密闭培养	密閉培養
密集	密集
密集点	密集する点
密集的	密集する
寒冷	寒冷だ
寡头垄断	寡占
寡头垄断市场	寡占市場
对	さが	及ぼすCu	対	対する
对于	対す
对于ANN	ANN
对于LDPE	LDPE
对于LDPE膜	LDPE膜
对于LDPE膜表面	LDPE膜表面
对于LDPE膜表面微成形	ミクロ成形するLDPE膜表面
对于LDPE膜表面成形	成形するLDPE膜表面
对于有	対す有する
对动力	対する動力
对双	対するバイナリー
对双基因	対するバイナリー遺伝子
对困难	対する困難だ
对干扰	対干渉
对干扰加	対干渉プラス
对干扰加噪声	対干渉プラスノイズ
对干扰加噪声比率	対干渉プラスノイズ比率
对干扰加噪声比率损失	対干渉プラスノイズ比率損失
对应	対応	対応する	応じる
对应实验	対応する実験
对应序列	応じるシーケンス
对应的价格	対応する価格
对应的接口	対応するIF
对应非常	対応する非常だ
对应非常能量	対応する非常だエネルギー
对应非常能量汇集	対応する非常だエネルギー集約
对最重要的意义	及ぼす最も重要だ意味
对比	コントラスト	対比	対比する
对比平均	コントラスト平均
对比率	対する比率
对比观察氟比洛芬酯	フルルビプロフェン
对波形	対す波形
对波形歪斜	対す波形歪む
对流	対流
对潜力	対する潜在力
对潜在	対する潜在
对烟	対する煙
对烧结温度	及ぼす焼結温度
对照	対照
对照区	対照区
对照组	よりコントロール	対照グループ	対照群
对照细胞	対照細胞
对物理	対する物理
对甲酸	及ぼすぎ酸
对甲酸乙酯	及ぼすぎ酸エチル
对电	対する優れる電気
对电催化	対する優れる電気触媒
对电催化活性	対する優れる電気触媒活性
对疫苗	たいするワクチン
对破碎	対する破砕
对破碎液	対する破砕液
对立	対立
对立基因	対立遺伝子
对策	対策
对经济	およぼす経済
对膨胀石墨	及ぼす膨張黒鉛
对象	するオブジェクト	オブジェクト	対象
对象区域	対象域
对象物	対象物
寻求	求める
导入	導入	導入する
导入研究	導入する研究	導入する研究する
导弹	ミサイル
将MEM	MEM
将MEM媒体	MEM媒体
小	小さい
小丘疹	小さい丘疹
小丘疹合并	小さい丘疹合併
小丘疹合并轻微	小さい丘疹合併軽微だ
小了Pd	小さいPd
小囊肿	小さい嚢胞
小精度	小さい精度
小经济	小さい経済
小经济开发	小さい経済開発
少	少い	少ない
少凝聚	少ない凝集
少负担	少ない負担
尺寸	サイズ
尺寸可变	サイズ可変だ
尺度	スケール
尺度评价	スケール評
尺度评分	スケール評点
尽管	/m
局	局
局部	局地	局所	局部
局部不变	局所不変だ
局部不变特征	局所不変だ特徴	局所不変だ特徴量
局部不变特征量提取	局所不変だ特徴量抽出
局部聚类梯度	局所クラスター勾配
局部集群	局所クラスター
局面	局面
层	層
层模型	層モデル
层电阻	層抵抗
居民	おける住民	住民
展开	展開
展开经济	展開経済
展望	展望
属	属
属于	属す
属反复	属反復
属反复基因	属反復遺伝子
履历	履歴
山岳	山岳
岳	岳
岳西	岳西
岳西县	岳西県
峰值	ピーク
峰值分析	ピーク解析
峰值分析法	ピーク解析法
峰值拟合	ピークフィッティング
峰值拟合法	ピークフィッティング法
峰值电流	ピーク電流
峰值部分	ピーク部分
嵌入	込む
嵌入式微	組む込むマイクロ
嵌入式微型	込むマイクロ
嵌入式微处理器	組む込むマイクロプロセッサ	込むマイクロプロセッサ
工业	工業
工作	する仕事	仕事	作動
工作的	仕事する	作動する
工具	ツール
工程	エンジニアリング	工学
工程设计	エンジニアリングデザイン
工程问题	エンジニアリング問題
左	左
左颈部	左頚部
巨大潜在	巨大だ潜在
巨大潜在相关	関する巨大だ潜在
巨大的	巨大だ
差分	差分
差分公式	差分式
差别	差別
差异	差	差異	異なる
差速度	差速度
巴德索登	バート
市	市
市场	マーケット	市場
市场容量	市場容量
市立	市立
市立大学	市立大学
希望	有望だ	望ましい
希望生物	望ましい生物
希望用途	有望だ用途
帝王	帝王
帝王切开	帝王切開
带	つきる	ストリップ	バンド	帯
带宽	帯域幅
带宽多通道	帯域マルチチャネル
带宽多通道雷达系统	帯域マルチチャネルレーダシステム
带来	もたらさ
带状	ベルト状
带状特性	ベルト状特性
带线路	ストリップ線路
带线路束流位置	ストリップ線路ビーム位置
带线路束流位置监测	ストリップ線路ビーム位置モニタ
带线路梁	ストリップ線路ビーム
常	常
常微分	常微分
常微分方程	常微分方程式
常搔	常に掻く
常数	定数
常见的	よく見る
常调谐的	よく同調する
常贯通	常貫通
常贯通过程	常貫通過程
常速率	常レート
常速率方程	常レート方程式
常飞跃	常に飛躍
幅度	幅
幅度调制	幅変調
干	干る
干扰	干渉	干渉する
干扰加	干渉プラス
干扰加噪声	干渉プラスノイズ
干扰加噪声比率	干渉プラスノイズ比率
干扰加噪声比率损失	干渉プラスノイズ比率損失
干扰气溶胶	干渉エアロゾル
干扰流动	干渉流動
干扰流场	干渉流動場
干扰烟幕	干渉する煙幕
干扰素	インターフェロン	フェロン	IFN
干扰素络合物生成	フェロン錯体生成だ
干扰素配合物	フェロン錯体
干扰翼	干渉翼
干葡萄	干るブドウ
平	平
平台	プラットフォーム
平均	平均
平均COD去除	平均COD除去
平均COD的	平均COD
平均值	平均値
平均粒	平均粒
平均粒度	平均粒度
平坦	平らだ
平坦DNA交叉	平らだDNAクロス
平坦DNA交叉杂交	平らだDNAクロスハイブリダイゼーション
平坦的DNA	平らだDNA
平滑部分	スムーズだ部分
平膜	平膜
平行	平行
平行的	平行する
平行计算	平行するコンピューティング
平衡	平衡
平衡解	平衡解
平面	平面
平面矩阵	面マトリックス
平面翼	平面翼
年龄	する年齢	年齢
并且相当	さらにかなり
并发症	合併症
并用	併用
并用过程	併用プロセス
幼体	幼生
幼虫	幼虫
幼虫头部	幼生頭部
幼虫饲养	飼育する幼生
幽门	幽門
幽门保存	幽門温存
幽门保存插入	幽門温存挿入
广周波	広い周波
广泛	広い
广泛景观	広い景観
广泛景观格局	広い景観パターン
广阔	広	広い
序	序
序列	シーケンス
序列分析	シーケンス分析	配列分析	配列解析	配列解析する
序列系统	シーケンス系統
序列试验	配列試験
序列进化树	シーケンス系統樹
应变	ひずむ
应用	応用	応用さ	応用可能だ
应用值	適用する値
应用程序	適用プロセス
应答	応答
底	アンダー
底剪切	アンダーカッティング
底流	底流
底流层	底流層
废	よる廃	廃
废水	よる廃水	廃水
度	度
度尺度	度スケール
座	座
廉价	安価だ
延伸	延伸
延伸状态	延伸状態
延伸状态调子	延伸状態調子
延伸的	延伸する
延伸长	より長い延伸
延迟	遅れる	遅延
延迟计算	遅延算定
建模	モデリング
建模复杂	モデリング複雑だ
建模复杂度	モデリング複雑だ度
建立	確立	確立する
建立基于	基づく確立	基づく確立する
建立新	つくる新規だ
建立新型漏斗	つくる新規だ漏斗
建造	つくる	造成	造成する
开	オン
开发	する開発	する開発する	より開発	基づく開発	開発	開発さ	開発する
开发动向	開発動向
开发的	より開発する
开发背景	開発背景
开口	開口	開口部
开口雷达	開口部ライダー
开始	始める	開始	開始さ	開始する
异常	異常だ
异常呼吸	異常だ呼吸
异黄酮	イソフラボン
引入	取り入れる
引出	引き出す
引导	導く
引物	プライマー
引起	もたらす	よって起こる	引く	引く付ける	引き起こす	起きる	起こす	起こる	起す
引起角	よって起こる角	起こる角
张	張
张力	張力
张量	テンソル
弯曲	曲げる
弯曲梁	曲げるビーム
弱	弱い
弱亚热带	弱い亜熱帯
弹性	弾性
弹性界面	弾性界	弾性界面
弹性界面活性	弾性界面活性
弹性表面	弾性表面
弹性表面活性	弾性表面活性
弹性表面活性剂	弾性界面活性剤	弾性表面活性剤
强	強い
强不稳定	強い不安定だ
强不稳定条件	強い不安定だ条件
强冷空气	強い寒気
强凝聚	強い凝集
强力技术	強力だ技術
强力的	強力だ
强化	強化	強化する
强回声	強いエコ
强对流	強い対流
强显示	強い示唆さ
强烈	強い
强烈暗示	強い示唆
强相关	強い関連	強い関連する
强调	強調	強調する
强风	強風
当地	現地
当地产业	地場産業
当局	当局
当选	当てる
形式	形	形式
形态	形態
形成	つくる	形成	形成する
形状	形状
形状特性	形状特性	状特性
形状设计	形状設計
影像	映像
影像雷达	映像レーダー
影像雷达系统	映像レーダーシステム
影响	およぼす	よって影響	よる影響	及ぼす	影響	影響する	関する影響
影响力	影響力
影响因素	影響因子
往往	しばしば
征候	徴候
径分布	径分布
径路	径路
很	よく
得到	よって得る	得る
得到乳清	よって得るホエー	得るホエー
得到乳清蛋白	よって得るホエー蛋白	よって得るホエー蛋白質	得るホエー蛋白	得るホエー蛋白質
循环	サイクル	循環
循环功能	循環機能
循环的	サイクルさ
循环系统	ループシステム
微	微
微乳	ミクロ乳
微乳头	ミクロ乳頭
微分	微分
微分方程	微分方程式
微分热	微分熱
微分热重量	微分熱重量
微分热重量分析	微分熱重量分析
微型	マイクロ
微处理器	マイクロプロセッサ
微小	微小だ
微小孔钛	微小だ細孔チタン
微小孔钛酸	微小だ細孔チタン酸
微小孔钛酸钠	微小だ細孔チタン酸ナトリウム
微小孔隙	微小だ細孔
微弧氧化法	マイクロアーク酸化
微弧电弧	マイクロアーク
微成形	ミクロ成形	ミクロ成形する
微成形对于LDPE	ミクロ成形するLDPE
微成形对于LDPE膜	ミクロ成形するLDPE膜
微机械	マイクロマシン
微机械加工	マイクロマシン加工	マイクロマシン加工さ
微波	マイクロ波
微波促进	マイクロ波促進
微波促进光	マイクロ波促進光
微波促进光分解	マイクロ波促進光分解
微波促进光分解二甲苯酚	マイクロ波促進光分解キシレノール
微波促进光分解二甲酚橙	マイクロ波促進光分解キシレノールオレンジ
微生物	微生物
微观	ミクロ
微观结构	微細だ構造
微观结构变换	微細だ構造変換
微观阵列	ミクロアレイ
微阵列	マイクロアレイ
微阵列分析	マイクロアレイ分析
德国	ドイツ
德国人物	ドイツ人物
德国人物理学	ドイツ人物理学
心理	心理
心理社会	心理社会
心理社会模式	心理社会モデル
心理障碍	心理障害
必要	必要だ	必要だ応じる
必要基础	必要だ基盤
必要基础因子	必要だ基盤因子
必要条件	必要だ条件
必要条件模型	必要だ条件モデル
必须	ないなら	必須だ
快速	迅速だ
快速开发	急速だ開発	急速だ開発する
忽视	無視	無視する
态度	態度
急性	急性
急性缺	急性虚
急性缺血	急性虚血
性	性
性别	性別
性状	形質
性能	する性能	パフォーマンス	性能
性能参数	性能パラメータ
性能实验	性能実験
性能曲线	性能曲線
性能试验	性能試験
性腺	性腺
性腺刺激	性腺刺激
性质	性質
总括	包括
总线	バス
总线系统	バスシステム
总结	つくまとめる	まとめる	まとめるする
总结了	つくまとめるする
总计	合計	総計
恒定速率方程	定常レート方程式
恢复	回復
恶劣	悪い
恶劣方法	悪い方法
患病	患う
患者	おける患者	よる患者	患者	有する患者	症患者
患者满意	おける患者満足	患者満足
患者满意度	おける患者満足度	患者満足度	患者満足感
患者满意度规模	おける患者満足度スケール	患者満足度スケール
患者自我	おける患者自己	患者自己
患者自我调节	おける患者自己調節	患者自己調節
患者自控静脉	おける患者自己調節静脈	患者自己調節静脈
患者自控静脉镇痛	おける患者自己調節静脈鎮痛	患者自己調節静脈鎮痛
悬浮	懸濁
悬浮液	懸濁液
情况	こと	ケース
情绪障碍	機嫌障害
惩治	退治する
想法	アイデア
意义	意味
意外	意外だ
意外伤害	意外だ傷害
意外伤害特别是	意外だ傷害特に
意外伤害特别是交通	意外だ傷害特に交通
意外伤害特别是交通事故	意外だ傷害特に交通事故
感受性	感受性
感应电压	誘導電圧
感应电压波形	誘導電圧波形
感染	感染	感染症
感觉	感	感じる	感覚
慢性	する慢性	慢性
慢性C型	する慢性C型	慢性C型
慢性丙型肝炎	する慢性C型肝炎	慢性C型肝炎
慢性丙型肝炎患者	する慢性C型肝炎患者	慢性C型肝炎患者
慢性乙型	慢性B型
慢性乙型肝炎	慢性B型肝炎
慢性萎缩	慢性萎縮
成人	成人
成像	イメージング
成像功能	イメージング機能
成分	成分
成分摘要	成分摘要
成功地	首尾よく
成功地获得	首尾よく得る
成形	成形	成形する
成形对于LDPE	成形するLDPE
成形对于LDPE膜	成形するLDPE膜
成本	コスト
成本削减	コスト削減
成本削减创新	コスト削減イノベーション
成本削减替代	コスト削減代替
成本削减替代创新	コスト削減代替イノベーション
我们	我々
战略	する戦略	戦略
所	所
所废	所廃
所废水	所廃水
所得	所得
所得税	所得税
所有	すべて	所有
所有代替专利权	代替特許権所有
所有公司	所有する会社	所有会社
所有的	所有する
手	手
手指	フィンガー
手指的	よってフィンガー
手术	手術
手术结束	手術終了
手段	手段
手续	手続き
打印方法	プリント法
打字	タイピング
打字结果	タイピング結果
执行	する実行	実行	実行する
扩增	増幅
扩增多	増幅多
扩增自然	増幅自然
扩增自然释放	増幅自然放出
扩大	拡大	拡大する
扩展有限	拡張有限だ
扩展有限元	拡張有限だ要素
扩展有限元法	拡張有限だ要素法
扩展频谱	拡張するスペクトル
扩张	拡張	拡張する
扩散	拡散
扫描	スキャン	走査
扫描图形	走査グラフ
扫描电子	走査電子
扫描电子显微	走査電子顕微
扫描电子显微镜	走査電子顕微鏡
扮演	演じる
找出	見つける出す	見出す
找到	見つける
承兑人	引き受ける人
承认	容認する
承认渔民	容認する漁民
技术	できる技術	技術
技术度	技術度
抑制	抑制	抑制する	抑圧	抑圧さ
抑制比率	阻害比率
抑制的	抑圧できる
抑制药	阻害薬
投用	投与	投与する
抗原	抗原
抛物柱	インペラー
抛物面	放物面
抛物面聚光	放物面集光
抛物面聚光器	放物面集光器
抛物面集	放物面集
报告	報告	報告さ	報告する
报告书	報告書
抵抗	対する抵抗	抵抗	抵抗する
抵抗外来	抵抗する外来
抵抗外来遗传基因	抵抗する外来遺伝子
抵抗外来遗传基因源	抵抗する外来遺伝子源
抽出	より抽出	抽出する
抽取	抽出
抽取试验	抽出試験
担当	担当
拆解	よって解く
拔出	引き抜く
拔出中心	引き抜くセンター
招致	招く
拟合	フィッティング	フィット
拟合法	フィッティング法
拷贝	コピー
持有	持た	持つ
持有企业	持つ型企業
持有型	持つ型
持有最优	持つ最適だ
持续	持続	続く
持续静脉	わたる静脈
指	指す
指出	指摘	指摘する
指向	ポインティング	指向
指向优点	指向利点
指导	指導	指導する
指数	指数
指数体系	指数体系
指数函数	指数関数
指数函数因子	指数関数因子
指标	指標
指示	指示	指示する
指纹	フィンガープリント
指纹法	フィンガープリント法
指针	指針
挥发	揮発
挥发物	揮発物
振动	振動
捕捉	する捉える	捉える
损伤	損傷	損傷する
损伤张量	損傷テンソル
损伤模式	損傷モード
损伤等级	損傷等級
损伤过程	損傷過程
损伤重	損傷重
损失	損失
排出液	排出液
排列	整列	整列さ	配列	配列決定
排放	排出
探查	探査
探测器	検出器
探讨	検討
接受	受ける	引き受ける
接受子宫	受ける子宮
接受子宫内膜	受ける子宮内膜
接受子宫内膜异位症	受ける子宮内膜症
接口	IF
接合	接合
接种	接種
接触	接触
接触比率	接触比率
接触氧化	接触酸化
接触氧化并用	接触酸化併用
接触氧化并用过程	接触酸化併用プロセス
接触角	接触角
接近	近づく	近接
控制	より制御	より制御さ	コント	コントロール	タクト	制御	制御さ	制御する	制御できる
控制功能	制御機能
控制器	コントローラー
控制器设计	コントローラー設計
控制方式	制御方式
控制法	制御法
控制系统	コントロールシステム	制御する系統	制御システム
控制组	コントロールグループ
推定	推定
推进	進む
掺杂	ドープ
掺杂光纤	ドープファイバ
掺杂光纤放大	ドープファイバ増幅
掺杂光纤放大器	ドープファイバ増幅器
描述	記述	記述さ
提供	供与	提供	提供する
提供许可	ライセンス供与
提供许可证	ライセンス供与する
提倡	提唱
提出	あげる	つく取上げる	出す	取上げる	提唱する	提案	提案さ	提案する
提出复杂	提唱する複雑だ
提出复杂系统	提唱する複雑だ系
提出方法	提案方法
提出法	提案法
提出的方法	提案する方法
提取效率	抽出効率
提取物	エキス	抽出物
提梁	づる
提梁感	感づる
提示	提示	提示する
提高	向上さ	高める
提高效率	効率向上
提高系统	高めるシステム
提高财政	向上する財政
插入	挿入
插座	ぺー
搅拌	撹拌	撹拌する	練る
搔	掻く
搜索	探索	探索する
搜索引擎	検索エンジン
搜索的AC	探索するAC
搜索的AC电力	探索するAC電力
搜索能力	探索能力
搬运	運搬
搬运能力	運搬能力
携带	キャリー	携帯
携带先	キャリー先
携带先块	ブロックキャリー先
携带先读理论	キャリー先読む論理
携带读取	キャリー先読む
摄像	撮像
摘要	摘要
摘除	摘出
摩擦	摩擦
摩擦的	する摩擦
操作	操作	操業
操作仿真	操業シミュレーション
操作员	オペレータ
操作员区域	オペレータ領域
操作员区域方式	オペレータ領域方式
操作结果	操業結果
操作结果预测	操業結果予測
操作群	操作群
支付	払う	支払
支付能力	支払能力
支持	サポート	支持さ
支持观光	支持観光
支持观光发展	支持観光発展
支援	支援
支撑	支持
支配	支配
收敛	収束
收敛区域	収束域
收集	収集	収集さ
改变	一変
改变分析	一変量解析
改善	改善	改善さ	改善する
改善方向	改善方向
改良	改良	改良する
改良既有加工法	既存加工法改良
改良液	改良液
改良液相	改良液相
改装	改装
改进液相还原	改良液相還元
改进液相还原法	改良液相還元法
改革	改革
改革计划	改革計画
攻击	攻撃
攻击性能	攻撃性能
攻击方式	攻撃方式
放大器	増幅器
放射	放射
放置	置く
政府	政府
政府管制	政府規制
政策	政策
政策支持	政策サポート
故障	故障
故障判定	故障判定
故障判定标准	故障判定基準
效应分子	エフェクター分子
效应器	エフェクター
效果	エフェクト	効果	関する効果
效果效率	効果効率
效率	効率	能率
效率系统	効率システム
敌人	敵
敌人手	敵手
敏感性试验	感受性試験
数	数
数值	数値
数值例子	数値例
数值模拟	数値シミュレーション
数值求积法	数値求積法
数列	数列
数字	デジタル
数字指纹	デジタルフィンガー	デジタルフィンガープリント	デジタルフィンガープリント法
数学	数学
数据	データ
数据曲线	データ曲線
数据连接	データ接続
数据连接部分	データ接続部
数据集	データセット
数模型	数モデル
数群最优	スウォーム最適だ
整体	全体
整体构成	全体構成
整体死亡	全体死亡
整合	統合する
整合的	統合するする
整流	整流
整流器	整流器
整流器负荷	整流器負荷
文件	ファイル
文本	テキスト
文本搜索引擎	テキスト検索エンジン
文本检索	テキスト検索
文献	文献
斑	斑
斑块	パッチ
斑块密度	パッチ密度
斑点	スポット
斑病	斑症
斑病患者	斑症患者
断定	断定	断定する
断定正确	断定する正確だ
断定正确方法	断定する正確だ方法
断层	CT
断言	断言	断言する
断面	断面
断面几何	断面幾何
斯威姆	スウォーム
斯托克斯	ストークス
斯托克斯公式	ストークス式
斯里兰卡	スリランカ
新	おける新しい	新規だ
新HCV	新しいHCV
新HCV蛋白酶	新しいHCVプロテアーゼ
新HCV蛋白酶抑制	新しいHCVプロテアーゼ阻害
新HCV蛋白酶抑制药	新しいHCVプロテアーゼ阻害薬
新型功率	新規だパワー
新型功率电子学	新規だパワーエレクトロニクス
新型漏斗	新規だ漏斗
新型电力电子器件	新規だパワーエレクトロニクス素子
新型钢级	新規だ鋼グレード
新技术	新しい技術
新方法	新しい手法	新規だ方法
新模型	ニューモデル
新病害	新しい病害
新的	ニュー	新しい	新規だ
新的不正当	新しい不正だ
新的不正当拷贝	新しい不正だコピー
新的类	新しいクラス
新研究	新規だ研究
新类	おける新しいクラス
新酶	新しい酵素
新钢	新規だ鋼
新鲜	新鮮だ
新鲜莲	新鮮だハス
新鲜莲叶	新鮮だハス葉
方位	方位
方位分解	方位分解
方位分辨率	方位分解能
方向	方向
方式	方式
方案	案
方法	する方法	する手法	基づく方法	手法	方法
方法算法	方法アルゴリズム
方法顺序	法手順
方程式	方程式
施行	施行
旅游开发	観光開発
旋转	回転	回転変だ
旋转变流机	回転変だ流機
旋转流动	ターン流	回転変だ流
旋转部分	部回転変だ
无	無い
无康复运动	無い元気だ動く
无性	無性だ
无性系	無性だ系
无性系茶	無性だ系茶
无机	無機
无机功能	無機機能
无机功能材料	無機機能材料
无机功能材料群	無機機能材料群
无机盐	無機塩
无机盐培养基	無機塩培地
无源光网络	受動光ネットワーク
无精神	無い元気だ
无菌	無菌
无菌试验	無菌試験
既存	既存する
既有	既存
既有加工	既存加工
既有加工法	既存加工法
时效	時効
时空	時空
昆明	昆明
昆虫	昆虫
昆虫抗性	昆虫抵抗
昌平(西燕)	昌平
昌平区	昌平区
昌平区疾病	昌平区疾病
昌平区疾病预防	昌平区疾病予防
昌平区疾病预防控制中心	昌平区疾病予防管理センター
昌平区疾病预防管理	昌平区疾病予防管理
明显	対す明らかだ	明	明らかだ
明显低于	有意だ低い
明显体系	明らかだ体系
明显减少	より減少し
明显变化	明らかだ変化	明白だ変化
明显地下降	有意だ下降
明显局部	明らかだ局所
明显的	明白だ
明显的局部聚类	明らかだ局所クラスター
明显的局部聚类梯度	明らかだ局所クラスター勾配
明显衰减	対す明らかだ減衰	明らかだ減衰
明显衰减效果	対す明らかだ減衰効果	明らかだ減衰効果
明白	分かつ
明确	明示する
明示	明示
明细胞	明細胞
易滑动的	容易だ滑り落ちる
映射	マッピング
映射作业	マッピング作業
映射作业台	マッピング作業台
映射程序	マッピングプログラム
是	みなさ
显微	顕微
显微镜	顕微鏡
显微镜观察	顕微鏡観察
显示	よって示さ	示さ	示す	表示	表示する
显示风景	示す風景
显示风景指标	示す風景指標
显著	おける有意だ	有意だ	顕著だ
显著减少	有意だ減少	有意だ減少する
显著增加	有意だ増加	有意だ増加する
显著差异	おける有意だ差	有意だ差
显著相关	有意だ相関
显著阻碍	有意だ阻害
显著高于	有意だ高い
景色	景色
景色点	景色スポット
景观	景観
景观分析	景観解析
景观分析数据	景観解析データ
景观指标	景観指標
景观数据	景観データ
景观格局	景観パターン
景观格局信息	景観パターン情報
景观格局分析	景観パターン解析
景观格局指标	景観パターン指標
景观生态	景観生態
景观评价	景観評価
景观评价指标	景観評価指標
晶体	結晶
智能	インテリジェンス
暖气	暖気
暖湿流	暖湿流
暗示	示唆	示唆さ	示唆する
暴露	暴露	暴露する
曲	曲
曲线	カーブ	プロフィル	曲線
曲线回归	曲線回帰
更	もっと	より	更に
更准确	より正確だ
更多	より多い	より多量だの
更多关注	より多量だ注目
更多报告	おいる多い報告	おいる多い報告さ
更好	より良い
更实用	もっと実用
更少的	より少ない
更接触	更に接触
更接触比率	更に接触比率
更效率	もっと能率
更新	アップデート
更新文件	アップデートする
更深	より深い
更碱基	より塩基
更简单	より簡単だ
更证明	より確証する
更进展	より進展する
更鉴定	より同定
更长的延伸	より長い延伸する
更非常	より非常だ
替代	代替
替代专利权	代替特許権
替代专利权所有公司	代替特許権所有会社
替代创新	代替イノベーション
替代特许	代替特許
最	おける最適だ	最も
最优	最適だ
最优值	最適だ値
最优值范围	最適だ値範囲
最优制法	最適だ製法
最优线性	最適だ線形
最优解	最適だ解
最优设计	最適だ設計
最佳	最適だの
最佳块	最適だブロック
最佳块分布	最適だブロック分布
最佳纯度	最適だ純度
最佳线性滤波器	最適だ線形フィルタ
最初	最初だ	最初の
最初块	最初だブロック
最初增加	最初だ増加	最初だ増加する
最初抑制	最初だ阻害
最初的例子	最初だ例
最初阻碍	最初だ阻害さ
最初风力	最初だ風力
最初风力发电	最初だ風力発電
最初风力发电站	最初だ風力発電所
最后	最後だ
最后接触	最後だ接触
最后接触比率	最後だ接触比率
最多	最多だ
最多发生	最多だ発生	最多だ発生する
最多发生骨折	最多だ発生する骨折
最大	最も大きい	最大だ
最大SS浓度	最大だSS濃度
最大值	最大だ値
最大分解	最大だ分解
最大分解速度	最大だ分解速度
最大检体	最大だ検体
最大检体量	最大だ検体量
最大浓度	最大だ濃度
最大的	おける最大だの	最大だの
最大的SS	最大だSS
最大的SS浓度	おける最大だSS濃度
最大相关	最大だ相関
最大相关点	最大だ相関点
最大衰减	最大だ減衰
最大衰减效果	最大だ減衰効果
最大要素	最大だ要素
最大量	最も大量だの
最大量风力	最も大量だ風力
最大量风力能源	最も大量だ風力エネルギー
最大集	最大だ集
最大集光度	最大だ集光度
最大集光度角度	最大だ集光度角度
最好	最もよい
最小	最小だ
最小值	最小だ値
最少	最少だ
最少值	最少だ値
最常见	最もよい見る
最稳定	最も安定
最稳定的	最も安定する
最终	最終だ
最膨胀	最も膨張
最膨胀剂	最も膨張剤
最解	おける最適だ解
最远	最も遠い
最重要的	最も重要だ
最重要的影响	及ぼす最も重要だ
最重要的意义	最も重要だ意味
最高	最強だ	最高だ
最高LNG	最強だLNG
最高的	最高の
有	あう	ある	しる	有	有す	有する
有升力	有する揚力
有变压器	有するトランス
有变更	有する変更さ
有意	有意だ
有意下降	有意だ下降する
有意义	有意だ
有意义的	おける有意だ
有效	おいる有効だ	有効だ	有効だ事
有效划分	有効だ分ける
有效对策	有効だ対策
有效所得税	実効所得税
有效攻击	有効だ攻撃
有效率	有効だ率
有效防止	有効だ防止	有効だ防止する
有效阻碍了	有意だ阻害する
有效降低	有意だ低減
有显著下降	有意だ下降する
有显著的降低	おける有意だ低減
有机	有機
有机物质	有機物質
有用	有用だ
有用工具	有用だツール
有益	有益だ
有相似	有する類似
有类似有机	有する類似有機
有能够持久耐久	有する長続きする耐久
有转基因	有するトランスジェニック
有转基因杨树	有するトランスジェニックポプラ
有限	有限だ
有限体积	有限だ体積
有限体积法	有限だ体積法
有限单元法	有限だ要素法
有限差	有限だ差
有限差分	有限だ差分
有限差分公式	有限だ差分式
有限要素	有限だ要素
服从	従う
服从生命	従う生命
服务	サービス
服务地方	サービス地場
服务地方产业	サービス地場産業
服务设备	サービス設備
期刊	ジャーナル
期望生物活性	望ましい生物活性
期权	オプション
木	木
末端	末端
末端标记	末端標識
本稿	本稿
本质	本質
术	術
机会	機会
机关	機関
机制	いうメカニズム	メカニズム	機序
机器	マシン	機器
机器加工	マシン加工	マシン加工さ
机器设计	機設計
机构	機構
机械	機械
机翼偏向	翼偏向
机翼干扰	翼干渉
机车	機関車
机车检修	機関車オーバーホール
机车要素	機関車要素
杀伤	キラー
杀虫	殺虫
杀虫剂	殺虫剤
杀虫剂浓度	殺虫剤濃度
杂交	ハイブリダイゼーション	ハイブリッド形成
杂音	雑音
权	権
权利	権利
权利交易	権利取引
权利应用	権利応用
权所有	権所有
权所有公司	権所有会社
权限	権限
杆菌	クロアカ	ロバクター
杆菌属	クター属	ロバクター属
杆菌属反复基因	ロバクター属反復遺伝子
材料	材料
材料群	材料群
束	束
束流位置	ビーム位置
束流位置监测	ビーム位置モニタ
条件	する条件	条件
条件构建	条件構築
条件模型	条件モデル
来	来る
来源	由来
杨树	ポプラ
杰出	傑出	傑出する
杰出性能	傑出する性能
杰出的	傑出する
板	板
极	極
极角度	極角度
极限接触	限界接触
极限接触比率	限界接触比率
构建	構築	構築する
构建块	構築ブロック
构成	成る	構成	構成さ
构成事	成る事
构成要素	構成要素
构成辅助	構成補助
构成辅助物	構成補助物
构造	造る
果真	果たして
枝	枝
某型	ある型
某硫酸	ある硫酸
某硫酸盐	ある硫酸塩
某说明	ある説明
染色	染色
染色水	染色水
柔性	柔軟だ
柔性冷却	柔軟だ冷却	柔軟だ冷却流
柔性冷却流路	柔軟だ冷却流路
柔性冷却流路控制	柔軟だ冷却流路制御
柔性冷却流路控制方式	柔軟だ冷却流路制御方式
柔性冷却策略	柔軟だ冷却戦略
查明	究明	究明する
柱	カラム
柴油	ディーゼル
柴油机	ディーゼル機関
柴油机车	ディーゼル機関車
柴油机车要素	ディーゼル機関車要素
标准	基準	標準
标准偏差	標準偏	標準偏差
标准法	標準法
标本	標本
标记	標識
标记在HSP	標識HSP
树	樹
树分析	樹分析
树木	樹木
树枝	木枝
树液	樹液
树液流动	樹液流
树脂	樹脂
树脂剂	樹脂剤
株	株
样品	サンプル
样品密度	サンプル密度
样式	様式
样本周期	サンプル周期
核	核
核心	コア	中核
核心处理器	コアプロセッサ
核心技术	中核技術
核生成	核生成だ
核磁共振	NMR
核糖体	リボソーム
核糖体DNA	リボソームDNA
核糖体DNA限制	リボソームDNA制限
核糖体DNA限制分析	リボソームDNA制限分析
核苷酸	ヌクレオチド
核苷酸多	ヌクレオチド多
根	根
根据	よる
根据ICM值	ICM値
桁架	トラス
桥梁	ブリッジ
梯度	勾配
梯形	台形
检体	検体
检体量	検体量
检修	オーバーホール
检修规制	オーバーホール規制
检查	する検査	検査	検査する
检查了	する検査する
检查基因	検査する遺伝子
检波	検波
检测	検出	検出する	検量	用いる検出
检索	検索
检量线	検量線
棋盘	盤
棋盘锦	盤錦
植物	プラント	植物
植被	植生
椎间盘	椎間板
椎间盘扩散	椎間板拡散
概念	概念
概括中国	概して中国
概括各种	概して種々だの
概率	確率
概率过程	確率過程
概率过程理论	確率過程理論
榨出	絞り出す
槽	スロット	トラフ
槽口	ノッチ
槽口位置	ノッチ位置
槽后方	トラフ後方
模块	モジュール
模型	するモデル	モデル
模型对照	モデル対照
模型对照组	モデル対照群
模型特性	モデル特性
模型特性法则	モデル特性法則
模式	パターン	モード	模式
模式信息	パターン情報
模式分析	パターン解析
模式指标	パターン指標
模式种	模式種
模拟	シミュレーションする	シミュレート	シミュレートする	擬似	模擬	模擬する
模拟了发烟	する発煙シミュレーション
模拟体液	擬似体液
模拟的	する模擬	する模擬する
模拟结果	シミュレーション結果
模拟验证	検証する模擬する
模糊	あいまいだ
模糊凹陷	あいまいだノッチ
模糊触点位置	あいまいだノッチ位置
横切地球	横切る地球
横切地球规模	横切る地球規模
横穿	横切る
橙	オレンジ
橡胶	ゴム
橡胶复合	ゴム複合
橡胶复合绝缘	ゴム複合絶縁
橡胶复合绝缘物	ゴム複合絶縁物
次	次
次带线路	ストリップ線路BPM
次系统	BPMシステム
止痒	痒
正	正
正交	直交
正交构成	直交構成
正交构成方程	直交構成方程式
正交构成的	よる直交構成
正交的	よる直交
正位	正所
正噪声比率损失	プラスノイズ比率損失
正常	正常だ
正常单	正常だ単
正常对照	正常だ対照
正常的	正常だの
正文	本文
正相关	正相関
正确	正確だ
正确反映	より正確だ反映	より正確だ反映する	正確だ反映	正確だ反映する
正确声源	正確だ音源
正确声源位置	正確だ音源位置
正确声源定位	正確だ音源位置決める
正确提出	正確だ提案	正確だ提案する
正确方法	正確だ方法
正确最优	正確だ最適だ
正确最优解	正確だ最適だ解
正确的	する正確だ
正确表示	正確だ表す
正确诊断	正確だ診断
正规	正規だ
步行	歩行
歪斜	歪	歪む
歪斜波形	歪む波形
死亡	死亡
残余	残
残存	残存	残存する
残差	残差
残差速度	残差速度
残渣	残渣
残留	残る
母	母
母子	母子
母集团	母集団
母集团评分	母集団評	母集団評点
每	あたる
比	比
比处理	比処理
比处理系统	比処理システム
比法	比法
比率	比率
比率损失	比率損失
比较	よって比較	比較	比較する	比較する事	比較的
比较了	よって比較する
比较模型	比較するモデル
比较范数	比較ノルム
毛	毛
民间	民間
民间领域	民間分野
气体	おけるガス	ガス
气体涡轮叶片	ガスタービンブレード
气体涡轮叶片流动	ガスタービンブレード流
气体涡轮叶片流路	ガスタービンブレード流路
气体涡轮叶片流路内侧	ガスタービンブレード流路内側
气体潴留	ガス貯留
气体翼	ガス翼
气体计	おけるガス計	ガス計
气候	候
气压	気圧
气溶胶	エアロゾル
气象	気象
气象特性	気象特性
气象状况	気象状況
气轮机	ガスタービン
氢	水素
氢氧化物	水酸化
氧化	酸化
氧化峰	酸化ピーク
氧化并用	酸化併用
氧化并用过程	酸化併用プロセス
氧化技术	酸化技術
氧化氢	酸化水素
氧化硫	酸化硫黄
氧化磷	酸化燐
氧化磷灰石	酸化燐灰石
氧化速度	酸化速度
氧化钛	チタニア
氧化铋	酸化ビスマス
氨基酸	アミノ酸
氮气吸附	窒素吸着
氮素	窒素
氯唑西林	クロキサシリン
氯唑西林协同作用	クロキサシリン相乗作用
氯唑西林相乘	クロキサシリン相乗
水	よび水	よる水	水
水位	水位
水体	水体
水反冲洗	水逆だ洗浄
水域	水域
水处理	水処理
水平	レベル	水平だ	水準
水平上升	レベルアップする
水平灵敏度	水平だ感度
水平级联	レベルカスケード
水果	果物
水氧化磷	水酸化燐
水氧化磷灰石	水酸化燐灰石
水流	水流
水流量	水流量
水滴	水滴
水热处理	よる水熱処理	水熱処理
水蒸气	水蒸気
水蒸气雾试验	水蒸気霧試験
水质	水質
水质标准	水質基準
水逆	水逆だ
水逆流	よび水逆流	水逆流
水逆流清洗	よび水逆流洗浄	水逆流洗浄
水逆清洗速度	水逆だ洗浄速度
汁液	汁
求积法	求積法
汇报	つきる報告
汇报了	つきる報告する
汉方	漢方
汗腺	汗腺
汗腺炎	汗腺炎
江苏	江蘇
污染	汚染
污泥	スラッジ
污物	汚物
污物肠	汚物腸
沈阳	瀋陽
沉积	堆積
沉积物	堆積物
沉降	沈降
沉降速度	沈降速度
沙漏	砂時計
沙漏控制	砂時計制御
没有	ない
河南	河南
油	油	SO
油样	油試料
油母页岩	オイルシェール
油母页岩燃烧	オイルシェール燃焼
油母页岩燃烧特性	オイルシェール燃焼特性
油气体储层	油ガス貯留層
油气体潴留	油ガス貯留
油煤气	油ガス
油田	油田
油的	よるSO
治疗	治療	治療する
治疗组	治療群
沿	沿う
沿着损伤	沿う損傷
沿着损伤过程	沿う損傷過程
法	法
法则	法則
法律	法律
法律实施	法律施行
法律领域	法則領域
法改良	法改良
波	波
波促进	波促進
波促进光	波促進光
波促进光分解	波促進光分解
波促进光分解二甲苯酚	波促進光分解キシレノール
波促进光分解二甲酚橙	波促進光分解キシレノールオレンジ
波光纤	波ファイバ
波光纤放大	波ファイバ増幅
波光纤放大器	波ファイバ増幅器
波动	波動
波动场	波動場
波动场传播	波動場伝播
波动场特性	波動場特性
波干扰气溶胶	波干渉エアロゾル
波干涉	波干渉
波应变	波ひずみ
波形	波形
波形扭曲	波形歪
波形歪斜	波形歪む
波结构	波構造
波辐射	波放射
波辐射特性	波放射特性
波镱	波イッテルビウム
波镱掺杂	波イッテルビウムドープ
波镱掺杂光纤	波イッテルビウムドープファイバ
波镱掺杂光纤放大	波イッテルビウムドープファイバ増幅
波镱掺杂光纤放大器	波イッテルビウムドープファイバ増幅器
波长	波長
注入	注入
注射	注射	注射する
注射样品	注射試料
注射组	注射群
泵	ポンプ
泵光纤	ポンプファイバ
泵光纤放大	ポンプファイバ増幅
泵参数	ポンプパラメータ
泵浦光纤放大器	ポンプファイバ増幅器
泵浦功率	ポンプパワー
洗脱液	溶出液
活力	活力
活性	活性
活性剂	活性剤
活性改善	活性改善
活性疫苗	活性ワクチン
活用	活用	活用する
流伤害	流傷害
流体	流体
流体力学	流体力学
流体模型	流体モデル
流体理论	流体理論
流体高炉	流体高炉
流体高炉模型	流体高炉モデル
流出	流出
流动	フロー	流	流れる	流動
流动场	流動場
流动小鼠	流マウス
流动干扰	流干渉
流动干扰流动	流干渉流動
流动干扰流场	流干渉流動場
流动机	流機
流动模型	流モデル	流動モデル
流动空气	流空気
流动空气灭火	流空気消火
流动空气灭火器	流空気消火器
流动细胞	流動細胞
流动细胞测量	流動細胞計測
流动细胞测量法	流動細胞計測法
流动资源	流動資源
流动送风机	流送風機
流变	レオロジー
流变特性	レオロジー特性
流域	流域
流平	流平
流平膜	流平膜
流群	流群
流行病学	疫学
流行病学分析	疫学分析
流路	流路
流路内侧	流路内側
流路控制	流路制御
流路控制方式	流路制御方式
流路管理	流路管理
流送风	流送風
流速	流速
流量	流束	流量
流量叶轮	流インペラー
流风机	流ファン
浆细胞	質細胞
测定	よって測定	よって測定する	より測定	より測定する	測定	測定する
测定评价	測定する評価	測定する評価する
测试	テスト
测试用例	テストケース
测量	よって測定する	計測
测量法	計測法
浓度	濃度
浓度依赖	濃度依存
浓度依赖方式	濃度依存様式
浓度比	濃度比
浓度范围	濃度範囲
浓缩	濃縮	濃縮する
浓缩技术	濃縮技術
浙江	浙江
浮游	浮遊
浮游函数	浮遊関数
浮游函数边界	浮遊関数境界
浮游函数边界条件	浮遊関数境界条件
海参	ナマコ
海参体	ナマコ体
海鲜	海鮮
海鲜餐厅	海鮮レストラン
浸蚀	浸食
浸蚀变量	浸食変数
浸蚀工艺	浸食プロセス
浸蚀状况	浸食状況
涂上	塗る
消化	消化
消化中央	消化器中央
消化中央部	消化器中央部
消化系统	消化器
消失	消失	消失する
消费	消費
消费电力	消費電力
涉及	及ぼす	及ぶ
涉及可能	及ぶ可能だ
涉及各种各样的	及ぼす様々だの
涉及各种各样的技术	及ぼす様々だ技術
涉及延迟	及ぼす遅延
涉及最	及ぼす最も
涉及烧结	及ぼす焼結
涉及膨胀	及ぼす膨張
涡轮	タービン
涡轮叶片	タービンブレード
涡轮叶片流动	タービンブレード流
涡轮叶片流路	タービンブレード流路
涡轮叶片流路内侧	タービンブレード流路内側
液	液
液水	液水
液泡内部	液胞内部
液泡膜	液胞膜
液相	液相
液相还原	液相還元
液相还原法	液相還元法
液胞	液胞
深	深	深い
深发展	より深い発展	深い発展
混入	混入	混入する
混凝剂	凝集剤
混合	ハイブリッド	合す	混合
混合变量	混合変数
混合变量最优	混合変数最適だ
混合变量的	おける混合変数
混合的	おける混合
混浊	濁る
混浊程度	濁る度
添加	添加
添加剂	剤添加
添加系统	剤添加系	添加系
添加絮凝剂	凝集剤添加
清楚	はっきり
清水	清水
清洗	洗浄
清洗速度	洗浄速度
渐近性	近的
渔业	漁業
渔业当局	漁業当局
渔业生产	漁業生産
渔业生产地区	漁業生産地域
渔业管理	漁業管理
渔业管理局	漁業管理局
渔业管理系统	漁業管理システム
渔业资源	漁業資源
渔民	漁民
渔获	漁獲
渗透	浸透
渗透光	浸透光
温室	温室
温度	温度
温度剖面	温度プロ
温度对比平均	温度コントラスト平均
温度对比度	温度コントラスト
温度循环	温度サイクル
温度控制	温度制御
温度控制法	温度制御法
温度曲线	温度プロフィル
温度梯度	温度勾配
游戏	ゲーム
游泳	泳
湍流	乱流
湍流干扰	乱流干渉
湍流干扰流动	乱流干渉流動
湍流干扰流场	乱流干渉流動場
湍流模型	乱流モデル
湖	湖
溃疡	潰瘍
源	源
源利用	源利用
源利用模式	源利用パターン
溶出	溶出
溶液	含む溶液	溶液
滑动的	滑り落ちる
滚筒	ローラー
滚筒设计	ローラー設計
滞留	滞留
满意	満足できる	満足だ
满意度	満足度	満足感
满意度规模	満足度スケール
满足	満たす	満足	満足する
满足相对	満たす相対
滤泡	濾胞
滤泡封闭	濾胞閉鎖
滤波器	フィルタ
滤饼层	ケーキ層
滤饼层阻力	ケーキ層抵抗
漂亮	きれいだ
漏斗	漏斗
潜力	ポテンシャル	潜在力
潜在	潜在
潴留	貯留
激光	レーザ
激光源	レーザ源
激动剂	アゴニスト
激素	ホルモン
激素激动剂	ホルモンアゴニスト
激素释放	ホルモン放出	刺激ホルモン放出
灌溉	潅漑
灭火	消火
灭火器	消火器
灰石	灰石
灵敏度	感度
灵活的	フレキシブルだ
灵活的交流	フレキシブルだ交流
灵活的交流传输	フレキシブルだ交流伝送
灵活的交流传输方式	フレキシブルだ交流伝送方式
炎	炎
炎症	炎症
点	する点	ドット	ポイント	点
点问题	点問題
烘箱	オーブン
烟幕	煙幕
烟雾	煙
烧结	焼結
烧结温度	焼結温度
热	ホットだ	熱
热传递	熱伝達
热分解	熱分解
热分解特性	熱分解特性
热分解生成	熱分解生成だ
热力学	熱力学
热处理	熱処理
热电	熱電
热电植物	熱電プラント
热离子	熱イオン
热粘贴	ホットだペースト
热解产物	熱分解生成だ物
热重量	熱重量
热重量分析	熱重量分析
热重量分析仪器	熱重量分析機器
热重量曲线	熱重量曲線
热量	熱量
焓	エンタルピー
焦点	焦点
焦点显微	焦点顕微
煙(消歧義)	スモーク
煤炭	石炭
煤炭试料	石炭試料
熔融	溶融
燃料	燃料
燃料电池	燃料電池
燃烧	燃焼
燃烧动	燃焼動
燃烧动力	燃焼動力
燃烧动态特性	燃焼動特性
燃烧实验	燃焼実験
燃烧特性	燃焼特性
片段	断片
片段多	断片多
牙齿	歯
牙齿专业	歯プロ
牙齿剖面	歯プロファイル
牛奶	牛乳
物	物
物培养基	物培地
物曲线	物曲線
物理	物理
物理化学	物理化学
物理探查	物理探査
物疑问	物疑問
物质	物質
物质输送	物質輸送
物质输送过程	物質輸送プロセス
特别交通	特に交通
特别是	特に
特别是交通事故	特に交通事故
特别是手机	特に携帯
特别是新	特に新規だ
特别是新钢	特に新規だ鋼
特别是新钢级	特に新規だ鋼グレード
特别蛋氨酸	特にメチオニン
特定	ある特定	特定
特定断面	特定断面
特定测试用例	ある特定テストケース	特定テストケース
特异基因	特異だ遺伝子
特异引物	特異だプライマー
特征	特徴	特徴づける
特征点	特徴点
特征量	特徴量
特征量提取	特徴量抽出
特性	特性
特性区域	特性区域
特性法则	特性法則
特性评价	特性評価
特性评价方法	特性評価法
特性预测	特性予測
特性频率	特性周波
特权	特権
特殊	特殊だ	特異だ
特殊处理	特殊だ処理
特殊形式	特殊だ形式
特色	特色
特许	特許
犯罪	犯罪
犯罪管制	犯罪規制
状	状
状况	状況
状态	ステート	状態
状态图	ステートチャート
状态图利用	ステートチャート利用
状态调子	状態調子
状态预测	状態予測
状碳	状炭素
独创	独創
独占	独占
独立	独立
独立疾病	独立疾患
独立的	独立する
独立高斯	独立するGaussian
独立高斯指	独立するGaussianフィンガー
独立高斯指纹	独立するGaussianフィンガープリント
猛然和	猛然たる
猛然和积极性	猛然たる積極
环境	環境
环境因素	環境因子
环境条件	環境条件
环境负荷	環境負荷
环状	環状
环状公园	環状公園
环状总线	環状バス
现场	現場
现场调查	現地調査	現地調査する
现存问题	既存する問題
现实	現実
现状	現状
现象	現象
玻璃	ガラス
玻璃状的	ガラス状
玻璃状碳	ガラス状炭素
玻碳电极	ガラス状炭素電極
球	球
球面	球面
球面子弹	球面弾丸
理学	理学
理想	理想
理由	理由
理解	理解
理论	より理論	理論	論理
理论的TG	理論TG
理论的TG曲线	理論TG曲線
理论结果	理論結果
生	生
生产	出産	生産
生产地区	生産地域
生产过剩	過剰だ産	過剰だ産生
生化	生化学
生命	生命
生命体征	生命徴候
生态	エコ	生態
生态划分	生態区分
生态环境	エコ環境	生態環境
生态规划	生態計画
生态适宜	生態適宜
生态适宜性	生態適宜性
生成	よって生成だ	よって生成ださ	生成だ	生成ださ
生成物	生成だ物
生活质量	クオリティオブライフ
生物	より生物	生体	生物
生物催化作用	生体触媒作用
生物催化剂	生体触媒
生物反应器	バイオリアクター
生物心理	より生物心理	生物心理
生物心理社会	より生物心理社会	生物心理社会
生物心理社会模式	より生物心理社会モデル	生物心理社会モデル
生物敏感性	生感受性
生物敏感性试验	生感受性試験
生物活性	生物活性
生物活性改善	生物活性改善
生物测定	バイオアッセイ
生物网络	生ネットワーク
生物防治	生物退治
生理	生理
生长	成長
生长指标	成長指標
生长评价	成長評価
生长评价系统	成長評価システム
生长速度	成長速度
用SPSS	SPSS
用例	用例
用药	投薬
用途	用途
由	より調
甲酸	ぎ酸
甲酸乙酯	ぎ酸エチル
甲醇	メタノール
电	おける電	電
电位	電位
电位波形	電位波形
电催化	電気触媒
电催化活性	電気触媒活性
电力	電力
电力供应	電力供給
电力切换	電力切換
电力切换配电	電力切換配電
电力切换配电系数	電力切換配電係数
电力基础	電力ベース
电力基础输电	電力ベース送電
电力基础输电权利	電力ベース送電権利
电力流动	電力フロー
电力运行	電力運転
电力运行点	電力運転ポイント
电化学	電気化学
电压	電圧
电压值	電圧値
电压偏移调节技术	電圧シフト調節技術
电压变化	電圧変化
电压波形	電圧波形
电压移位	電圧シフト
电压移位脉冲	電圧シフトパルス
电压移位脉宽	電圧シフトパルス幅
电压移位脉宽调制	電圧シフトパルス幅変調
电压移位调节	電圧シフト調節
电压频率	電圧周波
电器	電器
电子	エレクトロニクス	電子
电子分光法	電子分光法
电子器件	エレクトロニクス素子
电子密度	電子密度
电子显微	電子顕微
电子显微镜	電子顕微鏡
电子显微镜观察	電子顕微鏡観察
电子构建	電子構築
电子构建块	電子構築ブロック
电子设备	エレクトロニクス機器
电子领域	エレクトロニクス分野
电弧	アーク
电弧氧化	ロアーク酸化
电极	電極
电极电弧	電極アーク
电植物	電プラント
电气	電気
电池	電池
电泳	泳動	電気泳	電気泳動
电流	電流
电源管理半导体	パワーマネージメント半導体
电磁	電磁
电磁感应法	電磁誘導法
电磁诱导	電磁誘導
电荷	おける電荷	荷	電荷
电荷移动	おける電荷移動	荷移動	電荷移動
电荷转移过程	おける電荷移動過程	荷移動過程	電荷移動過程
电荷量	電荷量
电路	回路
电阻剖面	抵抗プロフィール
画	画
界限	限界
界面	界	界面
界面活性	界面活性
界面矩阵	界面マトリックス
畜牧	牧畜
畜牧业	牧畜業
畸变	ゆがむ
疏水	疎水
疑似	疑似
疑似目标	疑似ターゲット
疑问	疑問
疗法	療法
疫苗	ワクチン
疼痛	痛む
疼痛情况	痛むこと
疾病	疾患	疾病	病気
疾病原因	疾病原因
疾病预防	疾病予防
疾病预防控制中心	疾病予防管理センター
疾病预防管理	疾病予防管理
痂	かさぶた
病	病
病原	病原
病变	病変
病变大鼠	病変ラット
病变大鼠模型	病変ラットモデル
病害	病害
病情	病状
病毒	ウィルス	ウイルス
病毒NS	ウィルスNS
病理	病理
症	症
症候	症候
症状	症状
癌	癌
癌发生	癌発生
癌症对照	癌対照
癌症患者	癌患者
癌症风险	癌リスク
登录	登録する
登记	登録
白	白
白斑	白斑
白斑病	白斑症
白癜风患者	白斑症患者
白色	白色
白蚁	シロヒトリ
皂苷	サポニン
的	いう	おける	さ	する	せ	な	なる	よる	機嫌
的AC	するAC
的AC电力	するAC電力
的AC电力基础	するAC電力ベース
的BSR	おけるBSR
的DNA阳性	DNA陽性だ
的Km	Km
的LNG	LNG
的Rand	よるRand
的SNP	SNP
的SO	するSO
的SSCP	SSCP
的SS浓度	おけるSS濃度
的TG曲线	TG曲線
的XUL	おけるXUL
的价格	する価格
的传送	する伝送
的传送速度	する伝送速度
的体腔	する体腔
的体腔细胞	する体腔細胞
的体腔细胞培养条件	する体腔細胞培養条件
的修理	する修理
的公园	よる公園
的再现性能	する再現性能
的初级实验组	おけるプライマリ実験群
的前馈	くフィードフォワード
的壁面函数边界条件	する壁面関数境界条件
的复杂系统	する複雑だ系
的外来	する外来
的外来遗传基因	する外来遺伝子
的外来遗传基因源	する外来遺伝子源
的大豆	おける大豆
的大豆异黄酮	おける大豆イソフラボン
的大量挥发	おける大量だ揮発
的大量挥发物	おける大量だ揮発物
的容量	する容量
的对于LDPE	するLDPE
的对于LDPE膜	するLDPE膜
的对于LDPE膜表面	するLDPE膜表面
的幼体	する幼生
的数据集	するデータセット
的文献	おける文献
的方案	する案
的最大的SS	おける最大だSS
的服务	よるサービス
的服务设备	よるサービス設備
的正交构成方程	よる直交構成方程式
的正确方法	する正確だ方法
的歪斜	する歪む
的歪斜波形	する歪む波形
的淤泥	おけるスラッジ
的渔业	おける漁業
的渔业资源	おける漁業資源
的渔民	する漁民
的烟幕	する煙幕
的电力	おける電力
的电力运行	おける電力運転
的电力运行点	おける電力運転ポイント
的监理	おける監理
的翼	する翼
的肾虚	おける腎虚
的能力	おける力
的膨胀石墨	おける膨張黒鉛
的节水	おける節水
的节水灌溉	おける節水潅漑
的计算	するコンピューティング
的财政	する財政
的进一步	関するさらだ
的进一步研究	関するさらだ研究
的违法	よる違法だ
的逆	する逆だ
的逆人工	する逆だ人工
的逆人工开口	する逆だ人工開口	する逆だ人工開口部
的量	おける量
的量子	おける量子
的量子比特	おける量子ビット
的雷暴	おける雷雨
的风扇	おけるファン
的风扇性能	おけるファン性能
的风机性能试验	おけるファン性能試験
的骨折	する骨折
的高斯	するGaussian
的高斯指纹	するGaussianフィンガー	するGaussianフィンガープリント
皮	皮
皮下	皮下
皮下结	皮下結
皮下结节	皮下結節
皮层	皮層
皮层模型	皮層モデル
皮带	ベルト
皮肤	皮膚
盐	塩
盐城	塩城
盐城市	塩城市
盐培养基	塩培地
监控	モニタ
监测方法	モニタ手法
监理	監理
监理担当	監理担当
监理担当的	おける監理担当
监督	監督
盛京	盛京
盛京医院	盛京病院
目录分析	コンテンツ分析
目标	ターゲット	目標
目标函数	目的関数
目标检测	目標検出
目的	目的
盲	ブラインド	盲
盲速度	ブラインド速度
直径	径	直径
直接	直接	直接だ
直接PCR技术	直接PCR
直接PCR碱基序列	直接PCR塩基配列
直接PCR碱基序列测定	直接PCR塩基配列決定
直接一样实验	直接一様だ実験
直接一致	直接一様だ
直接原因	直接だ理由
直接原因引起	起す直接だ理由
直接培养	直接培養	直接培養する
直接培养体腔	直接培養する体腔
直接培养体腔细胞	直接培養する体腔細胞
直接引起	起す直接だの
直接总计	直接総計
直接扩增碱基	直接PCR塩基
直接提供	直接だ提供	直接だ提供する
直接的	直接の
直线	直線
直觉	直感
直面	直面	直面する
相	相
相乘	相乗
相乘效果效率	相乗効果効率
相乘效率	相乗効率
相乘效率提高	相乗効率向上
相乘系统	相乗システム
相乘系统基础	相乗システム基盤
相互	相互
相介质	相媒質
相介质模型	相媒質モデル
相介质理论	相媒質理論
相似性	相性
相位	位相
相位修正	位相補正
相位几何	位相幾何
相位参数	位相パラメータ
相位参数的	する位相パラメータ
相位幅度	相バンド幅
相位的	する位相
相位角	位相角
相位角位移	位相角シフト
相位角偏移调节	位相角シフト調節
相关	する相関	相関	相関す	関する	関する関連	関連	関連する
相关免疫	する相関免疫	相関免疫
相关免疫效应	する相関免疫エフェクター	相関免疫エフェクター
相关免疫效应分子	する相関免疫エフェクター分子	相関免疫エフェクター分子
相关关系	相関関係
相关因素	関する関連要因	関連要因
相关大量资源	関する大量だ資源
相关实证	関する実証
相关巨大	関する巨大だ
相关市场	関する市場
相关市场容量	関する市場容量
相关技术	関する技術
相关整合	関連統合
相关机制	関連機構
相关点	相関点
相关生活质量	関連クオリティオブライフ
相关疾病	関する疾病
相关疾病原因	関する疾病原因
相关的	関連する
相关的工作	関連する仕事
相关相	関する相
相关省	関する省
相关积	相関積
相关空	関する空
相关空力	関する空力
相关空力设计	関する空力設計
相关算法	相関アルゴリズム
相关系数	相関係数
相关良好	関する良い
相关良好基础	関する良い基礎
相关蛋白	関連タンパク
相关蛋白质	関連タンパク質
相关银杏	関するイチョウ
相关银杏叶	関するイチョウ葉
相关银杏叶提取物	関するイチョウ葉エキス
相关风	関する風
相反	反対だ
相反的	反対の
相各向异性	相異方性
相各向异性介质	相異方性媒質
相同	同じだ	同一だ
相同内容	同じだコンテンツ
相同基因	同じだ遺伝子
相同妊娠	同じだ妊娠
相同条件	同じだ条件
相同水平	同じだレベル
相同相位	同じだ位相
相同相位几何	同じだ位相幾何
相同知觉	同じだ知覚
相对	対す	相対
相对变化	対すバリエーション
相对含量	相対含量
相对回收	相対回収
相对带宽	相対帯域	相対帯域幅
相对标准	相対標準
相对标准偏差	相対標準偏	相対標準偏差
相对结晶	相対結晶
相对结晶度	相対結晶度
相带	相バンド
相应序列分析	応じるシーケンス分析
相应的	相応しい
相应的实验结果	対応する実験結果
相异	相違
相当	かなり
相当上升	かなり上昇	かなり上昇する
相比	比べる
相结构	相構造
相转换	相変換
相还原	相還元
相还原法	相還元法
省	省
看	見る
看Bi	よるBi
看见	見える	見る
真	真
真实有效的	真実だ
真空	真空
真空烘箱	真空オーブン
着	着る
着流程	着る流れる
着眼	着眼
着眼于	着眼する
瞄准	照準
知觉	知覚
知识	知的だ	知識
知识产生网络	知的だ創生ネットワーク
知识创造	知的だ創	知的だ創生
知识系统	知識システム
知识规模	知識規模
矩阵	マトリックス
矩阵不等式	マトリックス不等式
石	石
石台	石台
石墨层	黒鉛層
石灰	石灰
砂	砂
砂土	土砂
砂搬运	砂運搬
砂搬运能力	砂運搬能力
研究	する研究	する研究する	つく研究	つく研究する	なる研究	よって研究	より研究	研究	研究さ	研究する	関する研究
研究了	よって研究する
研究促进	研究促進
研究对象	研究対象
研究开发	研究開発	関する研究開発
研究母	研究母
研究母集团	研究母集団
研究母集团评分	研究母集団評	研究母集団評点
研究现状	研究現状
研究结果	研究結果
研究风景	研究風景
研究风景指标	研究風景指標
破坏	破壊	破壊さ
破损	破損
破损下部	破損下部
破损下部结构	破損下部構造
破损位置	破損位置
破损构成	破損構成
破损构成要素	破損構成要素
破水	破水
破碎	破砕
破裂	破る
破解	おける解
硅橡胶	シリコーンゴム
硅橡胶复合	シリコーンゴム複合
硅橡胶复合绝缘	シリコーンゴム複合絶縁
硅橡胶复合绝缘物	シリコーンゴム複合絶縁物
硅胶	シリコーン
硫磺	硫黄
硫酸	硫酸
硫酸盐	硫酸塩
硬件	ハードウェア
确定	よって確定	よって確立さ	確かめる	確定	確定する
确定了	つく確かめる
确定的	よって確定する
确实	確実だ
确立	よって確立	確立さ
确立了	よって確立する
确认	確認	確認さ	確認する	認める
确认方法	確認する方法
确认试验	確認試験
确证	確証
碱基	塩基
碱基序列	塩基配列
碱基序列测定	塩基配列決定
碱处理	アルカリ処理
碱性	アルカリ
碳	炭素
碳源	炭素源
碳源利用	炭素源利用
碳源利用模式	炭素源利用パターン
碳电极	炭素電極	状炭素電極
碳酸	炭酸
碳酸饮料	炭酸飲料
磁共振	MRI
磷	リン	燐
磷灰石	燐灰石
磷脂	リン脂質
磷脂脂肪	リン脂質脂肪
磷脂脂肪酸	リン脂質脂肪酸
磷脂脂肪酸模式	リン脂質脂肪酸パターン
磷酸	リン酸
磷酸缓冲	リン酸緩衝
磷酸缓冲液	リン酸緩衝液
社	社
社交	社交
社交障碍	社交障害
社会	社会
社会模型	社会モデル
社会环境	社会環境
神经	神経
神经回路	神経回路
神经网络	ニューラルネットワーク	神経回路網
离子	イオン
离子陷阱	イオントラップ
离开	離す
离心	遠心
离心分离	遠心分離
离散	離散
离散空间	離散空間
种	種
种关系	種関係
种对	種対
种类	種類
科	科
科学	科学
科学财团	科学財団
积	積
积分	積分
积分变换	積分変換
积分方式	積分方式
积分液	積分液
积分液态水	積分液水
积分顺序	積分手順
积极	積極	長続き
积极具有	有する長続き
积极的	長続きする
积累	蓄積
移位	シフト
移位脉冲	シフトパルス
移位脉冲宽度	シフトパルス幅
移位脉宽调制	シフトパルス幅変調
移位调节	シフト調節
移位调节技术	シフト調節技術
移动	おいる移動	移動
移动游戏	移動ゲーム
移动目标	おいる移動目標	移動目標
移动目标检测	おいる移動目標検出	移動目標検出
移动过程	移動過程
稀疏	疎だ
稀疏配置	疎だ配置
稀疏配置构成	疎だ配置構成
稀疏配置系统	疎だ配置システム
稀释	希釈
程序	プログラム
程序库	ライブラリ
程序库分析	ライブラリ分析
程度	程度
税	税
稳定	より安定	より安定する	安定	安定する	定常
稳定再现	安定する再現
稳定再现性能	安定する再現性能
稳定流变	安定レオロジー
稳定流变特性	安定レオロジー特性
稳定的	安定する
空	空
空力性能实验	空力性能実験
空力性能曲线	空力性能曲線
空气	空気
空气动力	空力
空气动力性能	空力性能
空气动力性能参数	空力性能パラメータ
空气动力设计	空力設計
空气反冲洗	空気逆だ洗浄
空气反冲洗速度	空気逆だ洗浄速度
空气导弹	空気ミサイル
空气淬火	空気消火
空气灭火器	空気消火器
空气逆	空気逆だ
空气逆流	空気逆流
空气逆流清洗	空気逆流洗浄
空洞	空洞
空洞QED	空洞QED
空间	空間
空间信息	空間情報
空间信息技术	空間情報技術
空间分布	空間分布
空间变量	空間変数
空间模式	空間パターン
空间配置	空間配置
站立	立つ
竞争	競争
竞争力	競争力
竞争状态	競争状態
端	端
端粒酶	テロメラーゼ
端粒酶催化	テロメラーゼ触媒
端粒酶催化亚基	テロメラーゼ触媒サブユニット
笔者	筆者
等价性	等価性
等位基因频率	対立遺伝子頻度
等位基因频率分布	対立遺伝子頻度分布
等级	グレード	等級
筛选	スクリーニング
简单	単純だ	簡単だ
简单得到	簡単だ得る
简单直觉	簡単だ直感
简单积分	簡単だ積分
简单积分方式	簡単だ積分方式
简称	略称
算法	アルゴリズム
管	パイプ
管理	マネージメント	管理
管理中心	管理センター
管理半导体	マネージメント半導体
管理局	管理局
管理系统	管理システム
管道	パイプライン
箱	箱
簇梯度	クラスター勾配
米尔模型	シュルモデル
类	クラス	類
类似	類似
类似有机	類似有機
类似有机物质	類似有機物質
类型	タイプ	型
类型断面	タイプ断面
类型断面几何	タイプ断面幾何
类癌	カルチノイド
粉末	粉末
粒	粒
粒子	パーティクル	粒子
粒子群系统最优	パーティクルスウォーム最適だ
粒子群计算法	パーティクルスウォーム
粒度	粒度
粒径	粒径
粘度	粘度
粘性	粘性
粘性底流	粘性底流
粘性底流层	粘性底流層
粘着	接着
粘贴	ペースト
精制	精製	精製する
精密	精密だ
精密带材	精密だストリップ
精密带线路	精密だストリップ線路
精密带线路束流位置	精密だストリップ線路ビーム位置
精密带线路束流位置监测	精密だストリップ線路ビーム位置モニタ
精密带线路梁	精密だストリップ線路ビーム
精度	決める精度	精度
精神	元気だ	精神
精神运动	元気だ動く
精神障碍	精神障害
精致	精緻だ
系数	係数
系统	する系統	システム	系	系統
系统乳油	系統EC
系统基础	システム基盤
系统树	系統樹
系统测试	システムテスト
系统现象	システム現象
系统进化树分析	系統樹分析
系茶	系茶
紊乱	乱れる
紊乱衰减	乱れる減衰
紊乱衰减水平	乱れる減衰レベル
索引	索引
索引文件	索引ファイル
紧密	ぴったり
紫	紫
紫外	紫外
紫外吸收	紫外吸収
紫外吸收光谱	紫外吸収スペクトル
紫外线	紫外線
紫外线分	紫外線分
紫外线分光	紫外線分光
紫外线分光光度	紫外線分光光度
紫外线分光光度法	紫外線分光光度法
累积	累積
累积损伤	累積損傷
累积损伤等级	累積損傷等級
絮凝剂添加系统	凝集剤添加系
红	赤
红外	赤外	IR
纤毛	シュル
约束	制約	拘束
约束的	拘束する
级联	カスケード
纯度	純度
纹理	く
纹理前馈神经回路	くフィードフォワード神経回路
纹理前馈神经网络	くフィードフォワード神経回路網
纺织复合	織物複合
纺织复合材料	織物複合材料
线	線
线圈	コイル	巻線
线性	線形
线性滤波器	線形フィルタ
线性矩阵	線形マトリックス
线性矩阵不等式	線形マトリックス不等式
线性结盟	線形結託
线性结盟攻击	線形結託攻撃
线性结盟攻击方式	線形結託攻撃方式
线路	ライン	線路
线路光束	線路ビーム
线路方程	ライン方程式
线路束流位置	線路ビーム位置
线路束流位置监测	線路ビーム位置モニタ
线路次	線路BPM
组	グループ	組
组合	コンビネーション	組む	組む込む	組み合わす	組み合わせる	組合す	組合せる	組合わせる
组合ONU	組み合わせるONU
组合创新	組合せる革新
组合数字	組み合わせるデジタル
组合数字指纹	組み合わせるデジタルフィンガー	組み合わせるデジタルフィンガープリント
组合数字指纹图谱	組み合わせるデジタルフィンガープリント法
组合说明	組み合わせる説明	組み合わせる説明する
组成	組成
组研究	グループ研究
组织	組織
组装	組み立てる
细	細い
细孔钛	細孔チタン
细孔钛酸	細孔チタン酸
细孔钛酸钠	細孔チタン酸ナトリウム
细微	微細だ
细微乳	細いミクロ乳
细微乳头	細いミクロ乳頭
细微观	細いミクロ
细胞	細胞
细胞凋亡	おけるアポトーシス	細胞アポトーシス
细胞凋亡程度	おけるアポトーシス度
细胞原	細胞原
细胞培养	細胞培養
细胞培养条件	細胞培養条件
细胞容积	細胞容積
细胞容积浓度	細胞容積濃度
细胞悬浮	細胞懸濁
细胞悬浮液	細胞懸濁液
细胞活力	細胞活力
细胞测量	細胞計測
细胞测量法	細胞計測法
细胞生理	細胞生理
细胞癌	細胞癌
细胞结构	細胞構造
细胞质	細胞質
细胞质膜	細胞原形質膜
细胞质膜渗透	細胞原形質膜透過
细胞遗传	細胞遺伝
细胞遗传现象	細胞遺伝現象
织物	織物
织物地区	織物地区
终极	究極
终止	終了
经常	常に
经常药物	しばしば薬物
经济	経済
经济开发	経済開発
经过	わたる
经过复杂	わたる複雑だ
经过复杂共同设计优化	わたる複雑だ共同設計最適だ
经过复杂协同设计	わたる複雑だ共同設計
经过设计	わたる設計
经过设计最优	わたる設計最適だ
结	結
结合	結合	結合さ
结合实验	結合する実験
结合实验室	結合する実験室	結合する実験室スケール
结合的	結合する
结合逆	結合する逆だ
结合逆人工	結合する逆だ人工
结合逆人工开口	結合する逆だ人工開口	結合する逆だ人工開口部
结晶大小	結晶サイズ
结晶度	結晶度
结构	構造
结构变换	構造変換
结构方程	構成方程式
结构系统	構造系
结构鉴定	構造同定
结果	結果
结果预测	結果予測
结盟	結託
结盟攻击	結託攻撃
结盟攻击方式	結託攻撃方式
结节	結節	結節合併
结节合并疼痛	結節合併痛む
结论	結論
结语	結語
绘制	レンダリング
给与	与える
给与算法	与えるアルゴリズム
络合物生成	錯体生成だ
绝对	絶対
绝对值	絶対値
绝缘	絶縁
绝缘物	絶縁物
统一实验	一様だ実験
统治	統治
统治指标	統治指標
统治状况	統治状況
统治状态	統治状態
统治评价	統治評価
统治评价系统	統治評価システム
维分布	次元分布
维动态发烟	次元動的だ発煙
维动态发烟仿真	次元動的だ発煙シミュレーション
维护	メインテナンス
维护计算	メインテナンス計算
维护计算量	メインテナンス計算量
维抽取试验	次元抽出試験
维持	維持	維持さ	維持する
维持策略	維持する戦略
维提取	次元抽出
维数	次元
维数动态	次元動的だ
维软件	次元ソフトウェア
维软件包	次元ソフトウェアパッケージ
综合	統合	総合
综合信息	統合情報
综合平台	統合プラットフォーム
综合症	症候群
综合评分	総合スコア
综合试验	総合試験
综合试验评价	総合試験評価
缓冲	緩衝
缓冲液	緩衝液
缓慢	ゆっくり
缓慢减少	ゆっくり減
编码	コード
缩小	縮小	縮小する
缺乏	欠乏	欠如	欠如する
缺点	欠点
缺血	虚血
网格	グリッド
网格风	グリッド風
网格风输出	グリッド風出力
网格风输出产业	グリッド風出力産業
网格风输出基础	グリッド風出力基盤
网格风输出开发	グリッド風出力開発
网络	ネット	ネットワーク	回路網	網
网络单元	ネットワークユニット
网络应用	回路網適用	網適用
网络控制	ネットワークコントロール
网络控制系统	ネットワークコントロールシステム
罗拉克	ロアーク
置换	置換
羊水	羊水
羊水正常	羊水正常だの
羊水正常单	羊水正常だ単
羊水过少	羊水過少だ
羊水过少组	羊水過少だグループ
美国	アメリカ
美国国家	アメリカ国立
美国国家科学	アメリカ国立科学
美国国家科学基金会	アメリカ国立科学財団
美国白蛾	アメリカシロヒトリ
羟基	ヒドロキシ
羟基安息	ヒドロキシ安息
羟基安息香	ヒドロキシ安息香
羟基苯甲酸	ヒドロキシ安息香酸
羟基苯甲酸酯	ヒドロキシ安息香酸エステル
群	群
群体	群れる
群落	群落
群落交叉平坦DNA杂交	群集平らだDNAクロスハイブリダイゼーション
群集	群集
群集平	群集平らだ
群集平坦DNA	群集平らだDNA
群集平坦的DNA交叉	群集平らだDNAクロス
翻转	ターン
翼	翼
翼偏向角度	翼偏向角度
老年	老年
考察	考察	考察する
考察了	考察する
考虑	する考える	考える	考慮	考慮する
考虑壁面	考慮する壁面
考虑壁面函数	考慮する壁面関数
考虑壁面函数边界	考慮する壁面関数境界
考虑壁面函数边界条件	考慮する壁面関数境界条件
耐久	耐久
耐久的	する耐久
耐用品	耐久財
耦合	役
职务	職務
职责	責務
聚乙烯	ポリエチレン
聚光	集光
聚光器	集光器
聚合酶链反应	PCR
聚合酶链反应定量	PCR定量
聚焦显微镜	焦点顕微鏡
聚类分析	クラスタ分析
聚集	凝集	集まる
肉	肉
肋骨	肋骨
肋骨骨折	肋骨骨折
肋骨骨折患者	肋骨骨折患者
肌肤	肌
肝炎	肝炎
肝炎患者	肝炎患者
肝脏	する肝臓	肝臓
肝脏损伤	損傷する肝臓
肠	腸
肠杆菌	エンテ	エンテロバ	エンテロバクター
肠杆菌属	エンテロバクター属
肠杆菌属反复	エンテロバクター属反復
肠杆菌属反复基因	エンテロバクター属反復遺伝子
肩	肩
肯尼亚	ケニア
肾功能	腎機能
肾损害	腎臓障害	腎障害
肾病	腎症
肾病综合	腎症候
肾脏	腎臓
肾脏基因	腎臓遺伝子
肾脏基因表达	腎臓遺伝子発現
肾脏基因表达剖面	腎臓遺伝子発現プロフィール
肾虚	腎虚
肾虚血	腎虚血
肾虚血的	おける腎虚血
肿瘤	腫瘍	腫瘤
肿瘤坏死	腫瘍壊死
肿瘤坏死因子	腫瘍壊死因子	TNF
胃	胃
胃炎	胃炎
胃炎大鼠	胃炎ラット
胃癌	胃癌
胃癌发生	胃癌発生
胃癌患者	胃癌患者
胃癌风险	胃癌リスク
胆汁	胆汁
胆汁类癌	胆汁カルチノイド
胆红素	ビリルビン
背景	背景
背景注入	背景注入
背部	背中
胚胎	いい
胞嘧啶	シトシン
胰腺炎	膵炎
胸部	胸部
胸部创伤	胸部創	胸部創傷
胸部外科	胸部外科
胸部外科手术	胸部外科手術
胸部手术	胸部手術
能	できる
能力	能	能力
能够持久有	有する長続きする
能够持久耐久	長続きする耐久
能够持久耐用品	長続きする耐久財
能检测	検出できる
能源	エネルギー源
能量	エネルギ	エネルギー
能量分散	エネルギー分散
能量分散X射线	エネルギー分散X線
能量分散X射线分	エネルギー分散X線分
能量分散X射线分光	エネルギー分散X線分光
能量分散X射线分光分析	エネルギー分散X線分光分析
能量多	エネルギー多
能量汇集	エネルギー集約
能量消耗	エネルギー多消費
脂肪	脂肪
脂肪乳	脂肪乳
脂肪酸	脂肪酸
脂肪酸模式	脂肪酸パターン
脂质	脂質
脂质脂肪	脂質脂肪
脂质脂肪酸	脂質脂肪酸
脂质脂肪酸模式	脂質脂肪酸パターン
脉冲	パルス
脉冲宽度	パルス幅
脉冲宽度调制	パルス幅変調
脱	脱
脱氧核糖核酸	DNA
脱附	脱着
脱附决定	脱着決定
脱附流程	脱着る流れる
腐蚀	腐食
腹	腹
腹膜	腹膜
膜	膜
膜浓缩	膜濃縮
膜浓缩技术	膜濃縮技術
膜清洗	膜洗浄
膜电阻	膜抵抗
膜表面	膜表面
膨胀	膨張
膨胀剂	膨張剤
膨胀方法	膨張方法
膨胀的	おける膨張
膨胀石墨	膨張黒鉛
自动	自動
自动映射	自動マッピング
自动映射程序	自動マッピングプログラム
自动设计	自動設計	自動設計さ
自定义逻辑	カスタムロジック
自定义逻辑模块	カスタムロジックモジュール
自尊	プライド
自己	自分
自我	自己
自我传播	自己伝搬
自我传播高温	自己伝搬高温
自我传播高温合成	自己伝搬高温合成
自我体像	ボディーイメージ障害自己
自我评价	自己評価
自我调节	自己調節
自我身体	自己身体
自控静脉	自己調節静脈
自控静脉镇痛	自己調節静脈鎮痛
自然	ナチュラルだ	自然
自然杀伤	ナチュラルだキラー
自然界	自然界
自然释放	自然放出
自由	自由だ
自由电子	自由だ電子
自由电子密度	自由だ電子密度
自觉	自覚	自覚する
自评量表	自己評価スケール
自身免疫	自己免疫
自身免疫状态	自己免疫状態
自适应处理	適応処理
致死	致死
致死浓度	致死濃度
良好	良い	良く	良好だ
良好一致	良く一致する
良好基础	良い基礎
良好延伸	良い延伸
良好拉伸状态调子	良い延伸状態調子
良好指标	良好だ指標
良好效果	良い効果
良好的	良好だ
良好的再现	良好だ再現
良好的延伸状态	良い延伸状態
良好的稳定	良好だ安定	良好だ安定する
良好的识别	良好だ認識
良好的识别性能	良好だ認識性能
良好稳定	良好だ安定	良好だ安定する
良好稳定的再现	良好だ安定する再現
良好稳定的再现性能	良好だ安定する再現性能
色调	色調
节	節
节水	節水
节水灌溉	節水潅漑
节点合并	節合併
节点合并疼痛	節合併痛む
节省能源	省エネルギー
芯片	チップ
芯片组	チップセット
花费	かから
芳烃	アレーン
芳烃修饰	アレーン修飾
芳烃修饰玻璃	アレーン修飾ガラス
芳烃修饰玻璃状	アレーン修飾ガラス状
芳烃修饰玻璃状碳	アレーン修飾ガラス状炭素
芳烃修饰玻碳电极	アレーン修飾ガラス状炭素電極
苦瓜	ニガウリ
苯甲酸	安息香酸
苯甲酸酯	安息香酸エステル
范围	レンジ	範囲
范数	ノルム
茎	茎
茎树液	茎樹液
茎树液流动	茎樹液流
茶	茶
茶园	茶園
荧光	蛍光
荧光原	蛍光原
荧光原位	蛍光原位置
荧光原位杂交	蛍光原位置ハイブリッド	蛍光原位置ハイブリッド形成
荫罩	バウアー
药	薬
药物	薬物
药物抵抗	薬物抵抗
药物抵抗剖面	薬物抵抗プロフィール
药症状	薬症状
药综合症	薬症候	薬症候群
莲	ハス
莲叶	ハス葉
获得	する得る	よって獲得	得る	獲得	獲得する
获得的	よって獲得する
菌	菌
菌株	菌株
菌类型	菌タイプ
菲	フェナントレン
菲的	するフェナントレン
萎缩	萎縮
著作	著書
葡萄	ブドウ
蒸汽雾	水蒸気霧
蒸腾	蒸散
蒸腾速率	蒸散速度
蔬菜	野菜
虚	虚
虚拟现实	仮想現実
虫	虫
虫体	虫体
蚕豆	ソラマメ
蛋氨酸	メチオニン
蛋白	タンパク	蛋白
蛋白质	タンパク質	蛋白質
蛋白质溶液	蛋白質溶液
蛋白质表面	蛋白質表面
蛋白酶	プロテアーゼ
蛋白酶抑制	プロテアーゼ阻害
蛋白酶抑制剂	プロテアーゼ阻害薬
蛋糕	ケーキ
蜂窝织炎	蜂巣炎
血	血
血标本	血サンプル
血清	血清
血清浓度	血清濃度
行CAG的	よるCAG
行为	挙動
衍射	回折
补偿	補償
补充	補完
补充线性	補完線形
表	表
表现	所見	表現	表現する
表示	表す
表示系统	表す系統
表达	発現
表达剖面	発現プロフィール
表面	よる表面	表面
表面处理	表面処理
表面处理水果	表面処理果物
表面张力	表面張	表面張力
表面摩擦	面摩擦
表面活性	表面活性	面活性
表面活性剂	界面活性剤	表面活性剤	面活性剤
表面积	表面積
表面质量	質表面
衰减	減衰
衰减性能	減衰性能
衰减效果	減衰効果
衰减水平	減衰レベル
袋	バッグ
被动	受動
被动光	受動光
裂纹	ひび割れる
装置	装置
西	西
西南	南西
西南射流	南西ジェット
西县	西県
要求	求める	要求	関する要求
要求条件	要求条件	関する要求条件
要点	要所	要点
要点要素	要所要素
要素	要素
要素基础	要素ベース
要素法	要素法
覆盖	被覆
见	見る	見つかる
观光	観光
观光参与度	観光関与度
观光发展	観光発展
观光影响	観光影響
观光相关	観光関与
观光路线	観光ルート
观察	観察	観察さ	観る察す	観察する
观察员	オブザーバー
观察镜	鏡観察
观测	観測	観測さ
观点	観点
规则	規則
规定	よって規定	定める	規定	規定さ	規定する
规定下	規定する下
规定的	よって規定する
规定的下	よって規定する下
规模	規模
规模适应性	規模適応
视觉	ビジュアルだ	対す視覚	視覚
视觉效果	ビジュアルだエフェクト
角	角
角位移	角シフト
角位移调节	角シフト調節
角度	角度
角条件	角条件
解	解
解决	解く	解決	解決する
解决方法	解決法
解剖	解剖
解法	解法
解法顺序	解法手順
解离	解離
解释	解釈
计	計
计划	計画
计划目标	計画目標
计时	計時
计时结果	計時結果
计算	する計算	する計算する	よって計算	よる計算	コンピューティング	子計算	用いる計算	用いる計算する	算定	計算	計算する
计算了	よって計算する
计算修理	計算する修理
计算数据	計算データ
计算方法	計算方法
计算机	コンピュータ	機
计算流体	計算流体
计算流体力学	計算流体力学
计算的	よって計算する
计算相位	計算する位相
计算相位参数	計算する位相パラメータ
计算结构	計算構造
计算结果	計算結果
计算量	計算量
认可	容認	認可
认可利用	認可利用
讨论	つく議論	つく議論する	検討する	議論	議論する
讨论了	議論する
训练	訓練	訓練する
训练收敛	訓練収束
议论	議
记录	記録	記録する
记忆	記銘
记忆领域	記銘領域
记载	記載	記載する
记述	記述する
许可	ライセンス
许可的	するライセンス	よるライセンス
许可策略	ライセンス戦略
论	論
论文	論文
论研究	論研究
设备	設備
设定	する設定	する設定する	設定	設定する
设定条件	設定条件
设置	する設置	する設置する	設ける	設置	設置する
设置容量	する設置する容量	設置する容量
设置无机	設ける無機
设置无机盐	設ける無機塩
设置无机盐培养基	設ける無機塩培地
设计	デザイン	設計	設計さ	設計する
设计参数	設計パラメータ
设计开发	設計する開発	設計する開発する
设计方案	設計案
设计方法	設計方法
设计最优	設計最適だ
设计的	設計する
设计轴	設計軸
设计轴流	設計軸流
设计轴流式风扇	設計軸流ファン
证	証
证据	証拠
证明	確証する	立証	証明	証明さ	証明する
评价	する評価	する評価する	より評価	レビューさ	評価	評価さ	評価する
评价了	より評価する
评价尺度	評価スケール
评价指标	評価指標
评价数据集	評価するデータセット
评价方法	評価法
评价的数据集	より評価するデータセット
评价系统	評価システム
评分	スコア	評	評点
评论	レビューする
识别	認識	認識する	識別
识别作用	識別作用
识别性能	認識性能
识别方法	識別方法
识别结果	識別結果
识别速度	識別速度
诊察	診察
诊断	診断	診断さ
诊疗	診療
诊疗进展	診療進展
词语	語
试剂	試薬
试料	試料
试行	試行
试验	試験	試験さ	試験する
试验方法	試験方法
试验法	試験法
试验结果	試行結果	試験結果
试验评价	試験評価
话题	トピック
详细	詳細だ
详细调查	詳細だ調べる
语言	する言語	言語
诱发	よって誘発	よって誘発さ	誘発	誘発さ	誘発する	誘起
诱发电位	誘起電位
诱发电位波形	誘起電位波形
诱导	誘導	誘導さ
诱导产生	よって生じる誘導	生じる誘導
诱导产生潜力	よって生じる誘導ポテンシャル	生じる誘導ポテンシャル
诱导公式	誘導式
诱导法	誘導法
诱导电位	誘導ポテンシャル
诱饵	デコイ
说明	つく説明	説明	説明する
说明了	つく説明する
说明的	説明する
调	調
调制	変調
调子	調子
调整	調整	調整する
调整开发	調整開発
调查	する調査	つく調べる	つく調査	つく調査する	より調べる	用いる調査	調べる	調査	調査さ	調査する
调查的	する調査さ
调查职务	調査職務
调节	調節
调节技术	調節技術
调节机	調節機
调节机制	調節機序
调节模式	調節モード
调节静脉	調節静脈
调节静脉镇痛	調節静脈鎮痛
贝加尔	バイカル
贝加尔湖	バイカル湖
贝叶斯	ベイジアン
贝叶斯正规	ベイジアン正規だ
贝塞尔	ベッセル
贝塞尔函数	ベッセル関数
负	負
负债	負債
负债水平	負債レベル
负担	負担
负相关	負相関
负荷	負荷
贡献	貢献	貢献する
财产	財
财团	財団
财政	財政
财源	財源
财源不足	財源不足
质树脂	質樹脂
质树脂剂	質樹脂剤
质膜	原形質膜	形質膜
质膜渗透	原形質膜透過	形質膜透過
质量	質	質量
质量分	質量分
贫乏	貧弱だ
贮藏	貯蔵
贯通	貫通
贯通过程	貫通過程
贯通速度	貫通速度
费用	料金	費用
费用补偿	費用補償
费用许可	料金ライセンス
资产	資産
资料	資料
资源	資源
资金	資金
起因	起因	起因する
起因偏	起因する偏
起因偏差	起因する偏差
起因歪斜	起因する歪む
起因歪斜波形	起因する歪む波形
起源	起原
超声波	音波
超声波检查	音波検査
超导	超伝導
超滤技术	限外ろ過技術
超滤膜	限外ろ過膜
超滤膜浓缩	限外ろ過膜濃縮
超滤膜浓缩技术	限外ろ過膜濃縮技術
超过	超える
距离	距離
距离卷	距離巻
距离感应电压	距離誘導電圧
距离感应电压波形	距離誘導電圧波形
距离线圈	距離巻線
距离诱导	距離誘導
跨复杂共同	わたる複雑だ共同
路	路
路内侧	路内側
路径	ルート
路径延迟	径路遅れる
路径控制	路制御
路径控制方式	路制御方式
路径管理	路管理
身体	身体
躯体	躯体
躯体疾病	躯体疾患
车	車
车要素	車要素
车辆检修	車オーバーホール
转	転
转向流路	ターン流路
转基因	ジェニック	トランスジェニック
转基因叶片	ジェニック葉	トランスジェニック葉
转基因杨树	ジェニックポプラ	トランスジェニックポプラ
转录	転写
转换	換える
转移	基転移	転移
转移酶	基転移酵素	転移酵素
软件	ソフト	ソフトウェア	込むソフトウェア
软件包	ソフトウェアパッケージ
软件模型	ソフトウェアモデル
软阴影	ソフト陰影
软阴影算法	ソフト陰影アルゴリズム
轴	軸
轴流	軸流
轴流叶轮	軸流インペラー
轴流式风扇	軸流ファン
轴流空气	軸流空気
轴流空气灭火	軸流空気消火
轴流空气灭火器	軸流空気消火器
轴流送风	軸流送風
轴流送风机	軸流送風機
轻微	軽微だ
较少的凝集	より少ない凝集
较弱	比較的弱い
辅助	補助
辅助物	補助物
辅助逐次	補助逐次
辅助逐次算法	補助逐次アルゴリズム
辐射信号	放射信号
辐射特性	放射特性
输入中断	インブレーク
输出	出力
输出产业	出力産業
输出产业开发	出力産業開発
输出光纤	出力ファイバ
输出光纤放大	出力ファイバ増幅
输出光纤放大器	出力ファイバ増幅器
输出基础	出力基盤
输出开发	出力開発
输出的	きれいだ出力
输出网络	出力ネットワーク
输沙	土砂輸送
输电	送電
输电权利	送電権利
输电权利交易	送電権利取引
输电权利应用	送電権利応用
输运理论	輸送理論
边界	境界
边界条件	境界条件
边界条件构建	境界条件構築
边界水域	境界水域
边界防卫	境界防衛
边缘	エッジ
辽宁	遼寧
达到	達す	達成する
达成	達成	達成さ	達成する
迅速	急速だ
迅速增加	急速だ増加
过剩	過剰だ
过剩捕捞	過剰だ漁獲
过剩生成	過剰だ生成だ
过去	過去
过少	過少だ
过少组	過少だグループ
过度	過
过氧化	過酸化
过氧化氢	過酸化水素
过滤	ろ過	外ろ過	濾過
过滤器	フィルター
过滤技术	ろ過技術	外ろ過技術
过滤特性	濾過特性
过滤系数	濾過係数
过滤膜	ろ過膜	外ろ過膜
过滤膜浓缩	ろ過膜濃縮
过滤膜浓缩技术	ろ過膜濃縮技術
过程	するプロセス	プロセス	過程
过程描述	プロセス記述
过程理论	過程理論
运动	動く	運動
运动补偿	動く補正
运动论	運動論
运动论研究	運動論研究
运行点	運転ポイント
运转	運転
运输	輸送
运输产业	輸送業
运输过程	輸送プロセス
近靶稳定	近的安定
返回技术	逆探技術
还原	還元
还原法	還元法
进一步	さらだ	さらに	よってさらに
进一步上升相当	さらにかなり上昇	さらにかなり上昇する
进一步划分	さらに分ける
进一步去除	さらに除去	さらに除去する
进一步发展	より進展
进一步增大	さらに増大
进一步实验	さらだ実験
进一步得到	さらに得る
进一步扩大	さらに増大さ
进一步研究	さらだ研究
进一步证明	さらに証明さ	よってさらに証明	よってさらに証明さ
进一步集成	さらに集積
进一步集成功率	さらに集積パワー
进一步集成功率集成电路	さらに集積パワーIC
进一步验证	さらに証明
进展	進む	進展	進展する
进展提供许可证	進むライセンス供与	進むライセンス供与する
进步	進歩
进程变量	プロセス変数
进程表达	プロセス表現
进行	行う	行く	行なう	行わ
进行了研究	より研究する
进行渔业	行う漁業
进行渔业管理	行う漁業管理
进行渔业管理局	行う漁業管理局
进行理论	つく理論
进行许可	進むライセンス
远	遠い
远方	遠方
远程	リモート
远程综合	リモート統合
远程综合信息	リモート統合情報
违法	違法だ
违法使用	違法だ使用
连接	接続
连接部分	接続部
连续	連続
连续冷却	連続冷却
连续冷却转变	連続冷却変態
连续区间	連続区間
连续定量	連続定量
连续操作	連続操作
连续波	連続波
连续波光纤	連続波ファイバ
连续波光纤放大	連続波ファイバ増幅
连续波光纤放大器	連続波ファイバ増幅器
连续波镱	連続波イッテルビウム
连续波镱掺杂	連続波イッテルビウムドープ
连续波镱掺杂光纤	連続波イッテルビウムドープファイバ
连续波镱掺杂光纤放大	連続波イッテルビウムドープファイバ増幅
连续波镱掺杂光纤放大器	連続波イッテルビウムドープファイバ増幅器
迟钝	鈍い
迟钝圆柱	鈍い円柱
追溯	遡及
追溯研究	遡及研究する
追踪	追跡
追踪检查	追跡検査
送风	送風
送风机	送風機
适合	適合	適合する
适宜	適宜
适宜性	適宜性
适应	適応	適応する
适应不可执行	順応する実行不可能だ
适应的	順応する
适应量	適応量
适当	適切だ	適正だ
适当优先	適切だ優先
适当法律	適切だ法律
适当法律施行	適切だ法律施行
适当的解释	適切だ解釈
适当识别	適切だ識別
适当识别速度	適切だ識別速度
适当量	適正だ量
适用	適用	適用さ	適用する	適用できる	適用可能だ
逆	逆だ
逆人工	逆だ人工
逆人工开口	逆だ人工開口
逆人工开口部	逆だ人工開口部
逆人工开口雷达	逆だ人工開口部ライダー
逆变器	インバータ
逆向清洗	逆だ洗浄
逆向清洗速度	逆だ洗浄速度
逆流	逆流
逆流清洗	逆流洗浄
逆转	逆転
逆转录	RT
逆转转录	逆転転写
逆风	逆風
逆风带	逆風帯
选定	選定	選定する
选择	選ば	選択	選択する
选择实验	選択する実験
选择实验数据	選択する実験データ
选择实验数据曲线	選択する実験データ曲線
透明细胞癌	明細胞癌
透过	透過
逐年	年々
逐年增加	年々増加
逐年高	年々高い
逐次	逐次
逐次算法	逐次アルゴリズム
逐渐	より徐々に	徐々に	次第に
逐渐减少	より徐々に減少	より徐々に減少する	徐々に減少	徐々に減少する
逐渐增加	次第に増える
逐渐扩大	徐々に拡大
逐渐扩大的	徐々に拡大する
通过	よって	通す	Pd
通过CPC	CPC
通过CTAB	CTAB
通过ICM	ICM
通过扩增	通す増幅	通す増幅する
通过抗原	よって抗原
通过指纹	よってフィンガープリント
通过控制系统	よりコントロールシステム
通过提示	通す提示	通す提示する
通过数值	よって数値
通过明	よって明
通过板	よって板
通过板冷却	よって板冷却
通过板冷却过程	よって板冷却過程
通过构造	よって造る
通过的	しする
通过确证	より確証
通过离散	通す離散
通过离散空间	通す離散空間
通过精制	通す精製	通す精製する
通过进行	よって行う
通过透明细胞	よって明細胞
通过透明细胞癌	よって明細胞癌
通过鉴定	より同定する
通过非常准确	より非常だ正確だ
通过鲁棒	よってロバストだ
通量	フラックス
通量密度	フラックス密度
通量密度波形	フラックス密度波形
通量密度波形扭曲	フラックス密度波形歪
速度	スピード	流速度	速度
速度分布	速度分布
速度参数	速度パラメータ
速度离心	速度遠心
速度离心分离	速度遠心分離
速度论	速度論
速率	レート
速率方程	レート方程式
逻辑	ロジック
逻辑模块	ロジックモジュール
遗传	遺伝
遗传基因	する遺伝子
遗传现象	遺伝現象
避免	避ける
邮件	メール
邮件的	メールする
部位	部位
部分	セクション	部	部分
部分区域	部分領域
部分区域积分	部分領域積分
部分区域积分方式	部分領域積分方式
部分旋转	部回転
部分旋转流动	部回転変だ流
部分雷达	部ライダー
部旋转变流机	部回転変だ流機
配合	合わせる
配合物	錯体
配备	備える
配电	配電
配电系数	配電係数
配置	配置
配置构成	配置構成
配置系统	配置システム
配置转换	配置換える
酯	エステル
酯酶	エステラーゼ
酯酶活性	エステラーゼ活性
酵母	酵母
酵母细胞	酵母細胞
酵母细胞悬浮	酵母細胞懸濁
酵母细胞悬浮液	酵母細胞懸濁液
酵母细胞生理	酵母細胞生理
酵母细胞结构	酵母細胞構造
酶	酵素
酶片段	酵素断片
酶片段多	酵素断片多
酸	酸
酸乙酯	酸エチル
酸模式	酸パターン
酸氧化	酸酸化
酸燃料	酸燃料
酸燃料电池	酸燃料電池
酸结构	酸構造
酸缓冲	酸緩衝
酸缓冲液	酸緩衝液
酸转移	酸基転移
酸转移酶	酸基転移酵素
酸酯	酸エステル
酸钠	酸ナトリウム
酿造	醸造
酿造所	醸造所
酿造所废	醸造所廃
酿造所废水	醸造所廃水
醋	酢
采用	採用	採用する
采集	採取	採取さ	採取する
释放	放出	放出する
释放子宫	放出子宮
重	重
重复	重複
重复合	重複合
重复合抛物面	重複合放物面
重复合抛物面聚光	重複合放物面集光
重复合抛物面聚光器	重複合放物面集光器
重复合抛物面集	重複合放物面集
重复基因	反復遺伝子
重复管理	重複管理
重庆	重慶
重新	見直す
重症	重症
重症急性	重症急性
重组	組換える
重要	する重要だ	与える主要だ	重要だ
重要作用	重要だ役割
重要因素	する重要だ因子	重要だ因子
重要意义	重要だ意味
重要方法	重要だ方法
重要物质	重要だ物質
重要物质运输	重要だ物質輸送
重要物质运输过程	重要だ物質輸送プロセス
重要的	重要だ
重要的话题	重要だトピック
重要结构	与える主要だ構造
重量	重量
重量分析	重量分析
重量分析仪器	重量分析機器
重量曲线	重量曲線
量	量
量子	量子
量子字节	子ビット
量子模拟	量子シミュレーション
量子比特	量子ビット
量子点	量子ドット
量子计算	量子コンピューティング	量子計算
量子计算机	量子コンピュータ
量提取	量抽出
鉴定	同定	同定する
钓鱼	釣る
钙	Ca
钛	チタン	Ti
钛酸	チタン酸
钛酸钠	チタン酸ナトリウム
钠	ナトリウム
钢	鋼
钢板	鋼板
钢板冷却过程	板冷却過程
钢梁构造	トラス構造
钢级	鋼グレード
钢部分	鋼部分
钾	カリウム
钾气体	カリウムガス
铁	鉄	Fe
铅	Pb
铋	ビスマス
铜	Cu
铝	アルミニウム	Al
铝疫苗	アルミニウムワクチン
银杏	イチョウ
银杏叶	イチョウ葉
银杏叶提取物	イチョウ葉エキス
铸型	鋳型
铸型表面	鋳型表面
链	鎖
链式反应	鎖反応
链的	鎖な
锌	Zn
错误	エラー	誤る
错误治疗	誤る治療
锦缎	錦
镁	Mg
镇痛	鎮痛
镍	Ni
镜	鏡
镱	イッテルビウム
镱掺杂	イッテルビウムドープ
镱掺杂光纤	イッテルビウムドープファイバ
镱掺杂光纤放大	イッテルビウムドープファイバ増幅
镱掺杂光纤放大器	イッテルビウムドープファイバ増幅器
长	より長い	長い
长延伸	長い延伸
长延伸的	長い延伸する
门延迟	ゲート遅れる
闭塞	閉塞	閉塞する
闭塞条件	閉塞する条件
问卷	アンケート
问卷调查	アンケート調査
问题	いう問題	する問題	問題	問題ない
问题点	問題点
闸门	ゲート
阅读	読む
阅读理论	読む論理
队列	隊列
队列研究	隊列研究
防卫	防衛
防御	防御
防止	防ぐ	防止	防止する
防治	退治
阳性	陽性だ
阳性异常	陽性だ異常だ
阳性样品	陽性だサンプル
阳极	アノード
阳极触媒	アノード触媒
阴影	シャドウ	陰影
阴影映射	シャドウマッピング
阴影算法	陰影アルゴリズム
阵列	アレイ
阵列分析	アレイ分析
阵列检测	アレイ検出
阵列检测器	アレイ検出器
阶层	階層
阶段	段階
阶段识别	段階識別
阶段识别方法	段階識別方法
阶段通过CPC	段階CPC
阻碍	阻害	阻害さ	阻害する
附加	プラス	付ける	付加
附属	付属
附属物	付属物
附属物疑问	付属物疑問
附属盛京	付属盛京
附属盛京医院	付属盛京病院
降低	低下する	低減	低減さ
降低了的	いる低下するする
降低的	いる低下	いる低下する	低下するする
降低部分	低下部分
降水	降水
降水量	降水量
限制	制限	制限する	規制
限制分析	制限分析
限制性内切酶	制限酵素
限制性片段多	制限酵素断片多
限制性酶切片段	制限酵素断片
限制片段	制限断片
限外过滤	限外ろ過
限度	限	限度
限度检修	限度オーバーホール
院	院
除去	除く	除去さ	除去する
陶瓷	セラミック
陶瓷沉降	セラミック沈降
陶瓷沉降速度	セラミック沈降速度
随机	ランダム
随机变化	変化ランダム
随机延迟	ランダム遅延
障碍	障害
障碍自我	障害自己
障碍自我评价	障害自己評価
障碍自评量表	障害自己評価スケール
集	集
集体评分	集団評点
集体评论	集団評
集光度	集光度
集光度角度	集光度角度
集合	セット	集合
集合值	集合値
集合值变分	集合値変分
集合值变分包含	集合値変分内包
集合值解决	集合値解決
集合值解决方法	集合値解決法
集团	集団
集平	集平らだ
集平DNA	集平らだDNA
集平坦DNA交叉	集平らだDNAクロス
集平坦DNA交叉杂交	集平らだDNAクロスハイブリダイゼーション
集成	集積	集積する
集成功率	集積パワー
集成功率的IC	集積パワーIC
集约	集約
集群	クラスタ	クラスター
雷暴	雷雨
雷莫司琼	ラモセトロン
雷达	ライダー	レーダ	レーダー
雷达回波	レーダエコ
雷达复合	レーダ複合
雷达复合诱饵	レーダ複合デコイ
雷达技术	ライダー技術
雷达系统	レーダシステム	レーダーシステム
雾	霧
雾特性	霧特性
雾箱	霧箱
雾试验	霧試験
雾问题	霧問題
需要	必要だ
需要序列	必要だ応じるシーケンス
需要序列分析	必要だ応じるシーケンス分析
需要热量	必要だ熱量
静态	静的だ
静态结构	静的だ構造
静脉	静脈
静脉血	静脈血
静脉血样本	静脈血サンプル
静脉镇痛	静脈鎮痛
非常	する非常だ	非常だ
非常一致	非常だ良い一致	非常だ良い一致する
非常复杂	非常だ複雑だ
非常好	非常だ良い	非常だ良好だ
非常快速开发	非常だ急速だ開発
非常正确	非常だ正確だ
非常正确表示	非常だ正確だ表す
非常正确表示通过	より非常だ正確だ表す
非常能量	する非常だエネルギー	非常だエネルギー
非常能量汇集	する非常だエネルギー集約	非常だエネルギー集約
非常迅速	非常だ急速だ
非常迅速开发	非常だ急速だ開発する
非常重要	非常だ重要だ
面	面
面向反对	向かう反対の
面向反对态度	向かう反対だ態度
面向对象	するオブジェクト指向	オブジェクト指向
面向对象优点	するオブジェクト指向利点
面向对象的优点	オブジェクト指向利点
面弹丸	面弾丸
面试	面接
革命	革命
鞭	鞭
鞭毛	鞭毛
音响	音響
音响计时	音響計時
音响计时结果	音響計時結果
项目	アイテム
项目健康	アイテム健康だ
项目健康调查	アイテム健康だ調査
顺利	スムーズだ
顺序	手順
顺应	順応
顺应不可执行解	順応する実行不可能だ解
顺应执行	順応する実行
预备	予備
预想	予想	予想する
预测	予測	予測する
预测结果	予測結果
预读	先読む
预读理论	先読む論理
预防	予防
预防接种	予防接種
预防管理	予防管理
预防管理中心	予防管理センター
领先	先取り
领域	分野	領域
颈部	頚部
频带	周波帯	帯域
频带宽度	バンド幅
频带覆盖	帯域マルチ
频率	頻度
频率分布	頻度分布
额外	限外
颠倒	逆探
风	風
风力	風力
风力发电	風力発電
风力发电站	風力発電所
风力能源	風力エネルギ	風力エネルギー
风扇	ファン
风扇性能	ファン性能
风扇空	ファン空
风扇空力性能	ファン空力性能
风扇空气动力	ファン空力
风景	風景
风景指标	風景指標
风机性能试验	ファン性能試験
风机气动性能实验	ファン空力性能実験
风输出	風出力
风输出产业	風出力産業
风输出产业开发	風出力産業開発
风输出基础	風出力基盤
风输出开发	風出力開発
风输出相关	関する風出力
风输出网络	風出力ネットワーク
风输出网络相关	関する風出力ネットワーク
风险	リスク
飞机	飛行機
飞跃	飛躍
食品	食品
食品产业	食品産業
食品填充	食品充填
食品填充物	食品充填物
食物	食	食物
食用	食べる
食醋	食酢
餐厅	レストラン
饮料	飲料
饮食习惯	食べる習慣
饱和	飽和
饱和前后	飽和する前後
饱和水	飽和水
饱和液	飽和液
饱和的	飽和する
饱和破碎	飽和破砕
饱和破碎液	飽和破砕液
饲养	飼育	飼育する
饲料	料
馈电	フィード
首先	まず	先ず
香	香
香港	香港
香港市立	香港市立
香港市立大学	香港市立大学
香酸	香酸
香酸酯	香酸エステル
马拉维	マラウイ
马里	マリ
马里实验	マリ実験
马里实验组	マリ実験群
驯化	たいする
驱动	駆動
驱动力	駆動力
驴	ロバ
验证	より検証	検証	検証する
验证了	より検証する	立証する
验证模拟	検証する模擬
骨	骨
骨折	骨折
骨折患者	骨折患者
高	より高い	高	高い
高Km值	高いKm値
高乳	高い乳
高乳头	高い乳頭
高压	高圧
高度	高度
高度槽	高度トラフ
高度槽后方	高度トラフ後方
高度能源消耗	高度エネルギー多消費
高度能量	高度エネルギー
高度能量多	高度エネルギー多
高支付	高い支払
高支付能力	高い支払能力
高效液相色谱	HPLC
高斯	ガウス	Gaussian
高斯函数	ガウス関数
高斯函数峰值	ガウス関数ピーク
高斯多	ガウスマルチ
高斯多峰	ガウスマルチピーク
高斯多峰值拟合	ガウスマルチピークフィッティング
高斯多峰拟合法	ガウスマルチピークフィッティング法
高斯指	Gaussianフィンガー
高斯指纹	Gaussianフィンガープリント
高智能	高いインテリジェンス
高温	高温
高温合成	高温合成
高炉	高炉
高炉操作	高炉操業
高炉操作仿真	高炉操業シミュレーション
高炉操作结果	高炉操業結果
高炉操作结果预测	高炉操業結果予測
高炉模型	高炉モデル
高的Km	高いKm
高级结构	高次構造
高质量	より高い品質	高い品質
高速	高速だ
高速携带先	高速だキャリー先
高速携带预读	高速だキャリー先読む
高速波	高速だ波
高速的	高速だの
高速轴	高速だ軸
高速轴流	高速だ軸流
高速轴流风扇	高速だ軸流ファン
高速进位	高速だキャリー
高速进位预读理论	高速だキャリー先読む論理
高阶	高次
高龄	高齢
鲁棒	ロバストだ
鲜明	より鮮明だ	鮮明だ
鲜明看见	より鮮明だ見える	鮮明だ見える
鳞	鱗
鸟嘌呤	グアニン
麦克风	マイク
麦芽	麦芽
麦芽汁	麦芽汁
黄瓜	キュウリ
黑铅	黒鉛
黑龙江	黒竜江
鼠标	マウス
齿轮	ギア
